county,time,date,cases,est_cases,est_omicron_cases,est_other_cases,tests,est_tests,est_omicron_tests,est_other_tests,hospitalizations,deaths,est_deaths,icu
Alameda,1,2021-12-23,4830,4841,2336,2505,95296,95526,45827,49699,57,10,10,16
Amador,1,2021-12-23,71,71,25,46,1632,1637,569,1068,3,0,0,2
Butte,1,2021-12-23,281,281,147,134,4283,4294,2236,2058,26,3,3,3
Calaveras,1,2021-12-23,67,67,26,41,1188,1191,453,738,0,1,1,1
Colusa,1,2021-12-23,8,8,3,5,298,298,117,181,2,0,0,0
Contra Costa,1,2021-12-23,2944,2952,1096,1856,47483,47598,17530,30068,30,3,3,10
Del Norte,1,2021-12-23,14,14,6,8,1344,1347,555,792,0,0,0,0
El Dorado,1,2021-12-23,335,335,125,210,4842,4854,1805,3049,8,2,2,2
Fresno,1,2021-12-23,1420,1424,500,924,25260,25321,8831,16490,108,18,18,46
Glenn,1,2021-12-23,40,40,16,24,463,463,186,277,0,0,0,0
Humboldt,1,2021-12-23,269,269,108,161,3670,3680,1459,2221,8,1,1,1
Imperial,1,2021-12-23,649,649,240,409,5862,5877,2190,3687,33,6,6,29
Inyo,1,2021-12-23,57,57,26,31,444,444,204,240,1,2,2,0
Kern,1,2021-12-23,1165,1167,464,703,22257,22310,8816,13494,77,21,21,27
Kings,1,2021-12-23,287,287,102,185,6068,6082,2145,3937,16,5,5,3
Lake,1,2021-12-23,35,35,12,23,1367,1372,462,910,0,1,1,0
Lassen,1,2021-12-23,18,18,8,10,2468,2474,1089,1385,1,0,0,0
Los Angeles,1,2021-12-23,60217,60363,43171,17192,795615,797525,565390,232135,669,111,111,181
Madera,1,2021-12-23,188,188,66,122,4834,4846,1692,3154,5,1,1,7
Marin,1,2021-12-23,1006,1008,387,621,15404,15441,5916,9525,4,1,1,1
Mariposa,1,2021-12-23,30,30,11,19,615,615,218,397,0,0,0,0
Mendocino,1,2021-12-23,82,82,23,59,2892,2898,805,2093,5,1,1,2
Merced,1,2021-12-23,395,395,154,241,5417,5430,2101,3329,11,8,8,11
Modoc,1,2021-12-23,5,5,2,3,59,59,24,35,3,0,0,0
Mono,1,2021-12-23,65,65,20,45,464,464,140,324,1,0,0,0
Monterey,1,2021-12-23,635,635,164,471,13795,13828,3557,10271,19,2,2,8
Napa,1,2021-12-23,471,471,193,278,5910,5924,2411,3513,3,0,0,2
Nevada,1,2021-12-23,191,191,64,127,2931,2937,988,1949,5,1,1,2
Orange,1,2021-12-23,9249,9271,3809,5462,114459,114733,46630,68103,175,27,27,54
Placer,1,2021-12-23,809,809,265,544,11431,11459,3719,7740,45,4,4,23
Plumas,1,2021-12-23,11,11,4,7,469,469,162,307,0,0,0,0
Riverside,1,2021-12-23,8578,8598,2986,5612,86173,86381,29817,56564,292,42,42,83
Sacramento,1,2021-12-23,3155,3164,1278,1886,53680,53809,21563,32246,128,23,23,35
San Benito,1,2021-12-23,185,185,86,99,2132,2136,975,1161,0,4,4,2
San Bernardino,1,2021-12-23,7845,7865,3755,4110,90074,90292,42915,47377,296,66,66,118
San Diego,1,2021-12-23,16659,16699,11495,5204,176345,176769,120889,55880,240,28,28,94
San Francisco,1,2021-12-23,5060,5072,1577,3495,68804,68969,21314,47655,20,3,3,13
San Joaquin,1,2021-12-23,1342,1346,512,834,23307,23363,8822,14541,42,13,13,23
San Luis Obispo,1,2021-12-23,682,682,301,381,11152,11179,4908,6271,14,1,1,7
San Mateo,1,2021-12-23,2942,2949,1506,1443,55217,55351,28093,27258,16,1,1,5
Santa Barbara,1,2021-12-23,1212,1216,490,726,15944,15982,6379,9603,23,4,4,11
Santa Clara,1,2021-12-23,5139,5151,3503,1648,112932,113203,76482,36721,73,9,9,39
Santa Cruz,1,2021-12-23,548,548,255,293,15243,15280,7020,8260,11,0,0,4
Shasta,1,2021-12-23,180,180,61,119,5146,5157,1771,3386,28,5,5,9
Siskiyou,1,2021-12-23,15,15,7,8,363,363,165,198,0,1,1,0
Solano,1,2021-12-23,822,823,338,485,16584,16624,6796,9828,25,2,2,5
Sonoma,1,2021-12-23,1184,1186,484,702,21445,21496,8738,12758,18,1,1,4
Stanislaus,1,2021-12-23,780,780,235,545,11412,11440,3425,8015,85,13,13,27
Sutter,1,2021-12-23,165,165,63,102,2230,2235,846,1389,0,0,0,0
Tehama,1,2021-12-23,57,57,16,41,1170,1173,325,848,8,0,0,1
Trinity,1,2021-12-23,1,1,0,1,105,105,33,72,0,1,1,0
Tulare,1,2021-12-23,510,510,149,361,11566,11592,3366,8226,32,18,18,10
Tuolumne,1,2021-12-23,121,121,42,79,1874,1879,654,1225,5,0,0,1
Ventura,1,2021-12-23,3115,3123,1616,1507,38504,38597,19845,18752,59,7,7,14
Yolo,1,2021-12-23,483,483,222,261,25635,25698,11724,13974,5,0,0,3
Yuba,1,2021-12-23,106,106,42,64,1748,1753,702,1051,4,0,0,5
Alameda,2,2021-12-30,13187,13221,7398,5823,98867,99118,55414,43704,106,7,7,23
Amador,2,2021-12-30,126,126,53,73,1782,1786,756,1030,4,1,1,2
Butte,2,2021-12-30,775,775,462,313,5334,5347,3202,2145,35,1,1,3
Calaveras,2,2021-12-30,137,137,63,74,1102,1105,508,597,1,0,0,1
Colusa,2,2021-12-30,51,51,24,27,296,296,140,156,4,0,0,0
Contra Costa,2,2021-12-30,9886,9911,4407,5504,56918,57063,25340,31723,46,4,4,21
Del Norte,2,2021-12-30,51,51,25,26,1869,1873,917,956,1,0,0,0
El Dorado,2,2021-12-30,933,935,420,515,5044,5057,2278,2779,11,3,3,4
Fresno,2,2021-12-30,4565,4577,1951,2626,32921,33006,14030,18976,129,16,16,41
Glenn,2,2021-12-30,67,67,32,35,513,513,246,267,0,0,0,0
Humboldt,2,2021-12-30,675,675,317,358,4301,4311,2051,2260,13,1,1,2
Imperial,2,2021-12-30,1358,1362,608,754,7618,7637,3424,4213,36,11,11,27
Inyo,2,2021-12-30,196,196,104,92,571,571,306,265,2,0,0,0
Kern,2,2021-12-30,3510,3519,1671,1848,28246,28317,13401,14916,85,16,16,30
Kings,2,2021-12-30,751,751,320,431,7108,7126,3062,4064,20,2,2,1
Lake,2,2021-12-30,123,123,50,73,1415,1419,587,832,0,0,0,0
Lassen,2,2021-12-30,30,30,16,14,2576,2583,1332,1251,2,0,0,0
Los Angeles,2,2021-12-30,155519,155915,120247,35668,841200,843343,650324,193019,1258,119,119,223
Madera,2,2021-12-30,576,576,245,331,5524,5538,2361,3177,5,1,1,1
Marin,2,2021-12-30,2156,2161,979,1182,17865,17910,8146,9764,8,1,1,1
Mariposa,2,2021-12-30,67,67,29,38,522,522,226,296,0,0,0,0
Mendocino,2,2021-12-30,301,301,104,197,2875,2881,998,1883,5,0,0,2
Merced,2,2021-12-30,1136,1140,529,611,7016,7034,3277,3757,11,5,5,10
Modoc,2,2021-12-30,6,6,3,3,52,52,26,26,0,0,0,0
Mono,2,2021-12-30,187,187,69,118,380,380,142,238,3,0,0,0
Monterey,2,2021-12-30,1755,1759,566,1193,16238,16280,5258,11022,17,4,4,11
Napa,2,2021-12-30,1409,1413,682,731,9586,9610,4648,4962,7,0,0,1
Nevada,2,2021-12-30,391,391,161,230,2077,2082,864,1218,3,0,0,1
Orange,2,2021-12-30,34584,34673,16783,17890,181859,182323,88159,94164,371,31,31,82
Placer,2,2021-12-30,2110,2114,841,1273,13304,13337,5303,8034,78,8,8,28
Plumas,2,2021-12-30,28,28,12,16,340,340,143,197,2,0,0,0
Riverside,2,2021-12-30,23914,23976,10063,13913,116006,116301,48856,67445,376,56,56,86
Sacramento,2,2021-12-30,9949,9974,4790,5184,67232,67404,32310,35094,163,23,23,49
San Benito,2,2021-12-30,586,586,313,273,2970,2977,1586,1391,1,3,3,3
San Bernardino,2,2021-12-30,25571,25637,14187,11450,116080,116376,64594,51782,441,66,66,149
San Diego,2,2021-12-30,47803,47926,35880,12046,212922,213466,159553,53913,400,28,28,110
San Francisco,2,2021-12-30,8881,8903,3352,5551,71583,71765,27165,44600,69,2,2,21
San Joaquin,2,2021-12-30,4713,4725,2152,2573,30243,30321,13812,16509,66,11,11,29
San Luis Obispo,2,2021-12-30,2024,2028,1049,979,14332,14369,7437,6932,21,1,1,7
San Mateo,2,2021-12-30,8067,8088,4705,3383,63753,63915,37305,26610,28,1,1,6
Santa Barbara,2,2021-12-30,3712,3722,1777,1945,20160,20212,9673,10539,46,6,6,9
Santa Clara,2,2021-12-30,15152,15191,11255,3936,124650,124968,92647,32321,133,9,9,50
Santa Cruz,2,2021-12-30,1582,1586,857,729,14327,14363,7802,6561,15,1,1,2
Shasta,2,2021-12-30,385,385,160,225,5291,5305,2219,3086,31,4,4,13
Siskiyou,2,2021-12-30,46,46,25,21,431,431,228,203,0,0,0,0
Solano,2,2021-12-30,3140,3147,1536,1611,22683,22742,11044,11698,46,6,6,8
Sonoma,2,2021-12-30,3456,3463,1673,1790,26779,26847,12996,13851,23,2,2,3
Stanislaus,2,2021-12-30,2234,2239,829,1410,15109,15147,5615,9532,95,11,11,19
Sutter,2,2021-12-30,317,317,144,173,2457,2462,1119,1343,0,3,3,0
Tehama,2,2021-12-30,130,130,44,86,1143,1146,394,752,3,3,3,3
Trinity,2,2021-12-30,7,7,3,4,95,95,37,58,0,0,0,0
Tulare,2,2021-12-30,1366,1370,493,877,13957,13993,5038,8955,42,7,7,7
Tuolumne,2,2021-12-30,244,244,103,141,1879,1883,795,1088,6,0,0,1
Ventura,2,2021-12-30,10128,10153,6014,4139,51830,51961,30806,21155,86,9,9,19
Yolo,2,2021-12-30,1413,1417,758,659,25067,25131,13538,11593,11,0,0,1
Yuba,2,2021-12-30,290,290,139,151,1906,1910,917,993,17,1,1,6
Alameda,3,2022-01-06,24965,25032,15778,9254,156630,157055,98990,58065,205,9,9,38
Amador,3,2022-01-06,315,315,155,160,2528,2534,1249,1285,4,0,0,2
Butte,3,2022-01-06,1658,1663,1104,559,8595,8619,5741,2878,43,0,0,4
Calaveras,3,2022-01-06,345,345,183,162,1984,1989,1062,927,0,2,2,2
Colusa,3,2022-01-06,57,57,31,26,553,553,302,251,5,0,0,0
Contra Costa,3,2022-01-06,16169,16213,8349,7864,85050,85280,44082,41198,111,12,12,22
Del Norte,3,2022-01-06,131,131,73,58,2478,2485,1396,1089,1,0,0,0
El Dorado,3,2022-01-06,1805,1809,944,865,7704,7724,4040,3684,11,6,6,4
Fresno,3,2022-01-06,9369,9395,4680,4715,48021,48150,23941,24209,243,17,17,40
Glenn,3,2022-01-06,140,140,78,62,747,748,414,334,3,1,1,0
Humboldt,3,2022-01-06,1200,1204,656,548,6914,6933,3800,3133,17,2,2,1
Imperial,3,2022-01-06,2969,2977,1554,1423,12097,12130,6324,5806,39,17,17,25
Inyo,3,2022-01-06,379,379,229,150,1129,1132,689,443,3,1,1,0
Kern,3,2022-01-06,9358,9382,5133,4249,47752,47881,26192,21689,136,16,16,31
Kings,3,2022-01-06,1678,1682,842,840,10145,10173,5106,5067,20,1,1,2
Lake,3,2022-01-06,372,372,179,193,2291,2297,1111,1186,3,1,1,1
Lassen,3,2022-01-06,102,102,60,42,3331,3339,1960,1379,2,0,0,0
Los Angeles,3,2022-01-06,282290,283055,231754,51301,1576071,1580351,1295184,285167,2511,199,199,391
Madera,3,2022-01-06,1364,1368,684,684,8868,8891,4452,4439,15,4,4,8
Marin,3,2022-01-06,2629,2636,1387,1249,17975,18023,9530,8493,18,1,1,2
Mariposa,3,2022-01-06,159,159,79,80,848,851,427,424,0,1,1,0
Mendocino,3,2022-01-06,668,668,276,392,4666,4677,1943,2734,3,1,1,2
Merced,3,2022-01-06,2634,2641,1427,1214,11470,11502,6203,5299,31,14,14,11
Modoc,3,2022-01-06,19,19,11,8,86,86,48,38,0,0,0,0
Mono,3,2022-01-06,217,217,96,121,658,659,294,365,2,1,1,0
Monterey,3,2022-01-06,3759,3769,1467,2302,27573,27647,10763,16884,52,4,4,10
Napa,3,2022-01-06,2322,2326,1288,1038,13144,13179,7304,5875,13,2,2,1
Nevada,3,2022-01-06,908,909,438,471,4073,4084,1978,2106,9,2,2,3
Orange,3,2022-01-06,54798,54946,30449,24497,272935,273676,152069,121607,657,68,68,122
Placer,3,2022-01-06,4081,4092,1921,2171,18267,18317,8602,9715,140,12,12,22
Plumas,3,2022-01-06,102,102,50,52,681,681,334,347,2,0,0,0
Riverside,3,2022-01-06,41248,41359,20284,21075,160433,160869,78985,81884,665,62,62,126
Sacramento,3,2022-01-06,22396,22456,12418,10038,103229,103509,57155,46354,250,31,31,69
San Benito,3,2022-01-06,878,880,532,348,3899,3909,2362,1547,4,0,0,2
San Bernardino,3,2022-01-06,40899,41011,25575,15436,158842,159273,99519,59754,696,83,83,166
San Diego,3,2022-01-06,75523,75728,60434,15294,299284,300096,239421,60675,681,40,40,156
San Francisco,3,2022-01-06,14529,14569,6525,8044,103407,103688,46612,57076,109,9,9,24
San Joaquin,3,2022-01-06,11032,11063,5841,5222,51360,51500,27238,24262,101,16,16,27
San Luis Obispo,3,2022-01-06,3582,3591,2124,1467,18621,18673,11015,7658,25,6,6,9
San Mateo,3,2022-01-06,13142,13177,8563,4614,96912,97174,63286,33888,56,7,7,11
Santa Barbara,3,2022-01-06,7337,7357,4043,3314,38603,38707,21308,17399,67,7,7,8
Santa Clara,3,2022-01-06,31058,31142,24674,6468,223581,224188,177940,46248,262,13,13,62
Santa Cruz,3,2022-01-06,3791,3802,2328,1474,34117,34210,21040,13170,17,4,4,0
Shasta,3,2022-01-06,868,869,424,445,7286,7306,3585,3721,33,7,7,12
Siskiyou,3,2022-01-06,96,96,57,39,771,772,463,309,3,1,1,1
Solano,3,2022-01-06,5359,5375,3001,2374,30034,30116,16780,13336,64,5,5,12
Sonoma,3,2022-01-06,6966,6987,3889,3098,39171,39276,21832,17444,42,8,8,6
Stanislaus,3,2022-01-06,4931,4945,2178,2767,22778,22840,10075,12765,137,12,12,16
Sutter,3,2022-01-06,883,884,466,418,4007,4018,2121,1897,0,2,2,0
Tehama,3,2022-01-06,406,406,168,238,2071,2075,861,1214,8,1,1,2
Trinity,3,2022-01-06,22,22,10,12,207,207,96,111,0,0,0,0
Tulare,3,2022-01-06,3559,3569,1538,2031,19535,19587,8433,11154,56,8,8,8
Tuolumne,3,2022-01-06,588,588,290,298,3399,3409,1690,1719,10,3,3,1
Ventura,3,2022-01-06,15538,15581,10278,5303,74699,74901,49537,25364,165,10,10,31
Yolo,3,2022-01-06,3396,3406,2063,1343,40623,40734,24807,15927,7,3,3,2
Yuba,3,2022-01-06,790,791,438,353,3265,3275,1815,1460,22,1,1,5
Alameda,4,2022-01-13,28689,28772,19801,8971,189415,189969,130992,58977,349,13,13,52
Amador,4,2022-01-13,456,456,256,200,3703,3715,2102,1613,5,2,2,3
Butte,4,2022-01-13,2127,2134,1544,590,9976,10006,7243,2763,49,4,4,5
Calaveras,4,2022-01-13,643,643,385,258,2733,2740,1644,1096,2,0,0,2
Colusa,4,2022-01-13,154,154,94,60,797,799,488,311,3,0,0,0
Contra Costa,4,2022-01-13,17325,17375,10106,7269,98876,99165,57818,41347,183,20,20,31
Del Norte,4,2022-01-13,190,190,119,71,5109,5123,3196,1927,2,0,0,1
El Dorado,4,2022-01-13,2271,2278,1340,938,9119,9146,5386,3760,12,3,3,1
Fresno,4,2022-01-13,15782,15829,8954,6875,66158,66352,37515,28837,328,15,15,62
Glenn,4,2022-01-13,284,284,177,107,1025,1029,639,390,0,0,0,0
Humboldt,4,2022-01-13,1369,1374,839,535,9023,9049,5560,3489,20,4,4,8
Imperial,4,2022-01-13,3758,3769,2221,1548,14317,14360,8463,5897,66,7,7,29
Inyo,4,2022-01-13,373,373,249,124,1261,1265,847,418,3,1,1,1
Kern,4,2022-01-13,13238,13277,8156,5121,60676,60853,37380,23473,202,27,27,42
Kings,4,2022-01-13,3264,3275,1876,1399,15827,15874,9091,6783,39,3,3,3
Lake,4,2022-01-13,555,555,305,250,2923,2930,1619,1311,2,2,2,2
Lassen,4,2022-01-13,256,256,168,88,3766,3777,2472,1305,0,0,0,0
Los Angeles,4,2022-01-13,279394,280207,239349,40858,1885222,1890723,1617843,272880,3657,352,352,600
Madera,4,2022-01-13,2218,2224,1261,963,10683,10715,6101,4614,28,2,2,6
Marin,4,2022-01-13,2848,2855,1697,1158,20578,20639,12289,8350,29,3,3,4
Mariposa,4,2022-01-13,186,186,105,81,1204,1209,684,525,0,0,0,0
Mendocino,4,2022-01-13,970,972,468,504,5603,5620,2713,2907,12,3,3,1
Merced,4,2022-01-13,4027,4038,2449,1589,14840,14885,9020,5865,39,15,15,10
Modoc,4,2022-01-13,8,8,5,3,104,104,65,39,0,0,0,0
Mono,4,2022-01-13,252,252,129,123,871,872,446,426,0,0,0,0
Monterey,4,2022-01-13,5574,5590,2554,3036,30923,31013,14119,16894,51,6,6,14
Napa,4,2022-01-13,2352,2358,1457,901,13924,13965,8663,5302,25,0,0,5
Nevada,4,2022-01-13,1331,1336,736,600,5656,5673,3133,2540,13,2,2,1
Orange,4,2022-01-13,51210,51360,31788,19572,296312,297176,184565,112611,983,102,102,171
Placer,4,2022-01-13,4928,4942,2645,2297,21855,21919,11763,10156,172,7,7,33
Plumas,4,2022-01-13,185,185,103,82,795,797,442,355,5,0,0,0
Riverside,4,2022-01-13,46980,47117,26317,20800,184561,185100,103512,81588,840,85,85,151
Sacramento,4,2022-01-13,24878,24949,15378,9571,116058,116398,71878,44520,423,43,43,82
San Benito,4,2022-01-13,934,936,623,313,4415,4428,2954,1474,5,2,2,3
San Bernardino,4,2022-01-13,44670,44800,30639,14161,186253,186798,127987,58811,888,125,125,219
San Diego,4,2022-01-13,72077,72287,60561,11726,303463,304348,255079,49269,1002,76,76,178
San Francisco,4,2022-01-13,12644,12681,6530,6151,106005,106312,54867,51445,187,14,14,41
San Joaquin,4,2022-01-13,14483,14526,8624,5902,65030,65221,38784,26437,170,17,17,47
San Luis Obispo,4,2022-01-13,4247,4259,2784,1475,23175,23242,15211,8031,36,7,7,8
San Mateo,4,2022-01-13,14753,14796,10501,4295,113858,114189,81165,33024,117,6,6,21
Santa Barbara,4,2022-01-13,7956,7979,4912,3067,46669,46804,28837,17967,93,8,8,10
Santa Clara,4,2022-01-13,32878,32974,27490,5484,263281,264050,220383,43667,394,23,23,67
Santa Cruz,4,2022-01-13,4218,4230,2850,1380,43826,43953,29713,14240,32,3,3,3
Shasta,4,2022-01-13,1232,1236,692,544,9456,9484,5317,4167,49,5,5,11
Siskiyou,4,2022-01-13,153,153,102,51,1092,1095,727,368,2,1,1,2
Solano,4,2022-01-13,6739,6758,4206,2552,36929,37037,23055,13982,101,5,5,16
Sonoma,4,2022-01-13,8542,8568,5317,3251,48841,48985,30454,18531,74,8,8,11
Stanislaus,4,2022-01-13,7605,7627,3881,3746,31179,31270,15923,15347,191,8,8,29
Sutter,4,2022-01-13,1376,1380,819,561,5155,5169,3073,2096,0,4,4,0
Tehama,4,2022-01-13,597,597,288,309,2569,2576,1243,1333,18,2,2,2
Trinity,4,2022-01-13,44,44,23,21,270,270,142,128,0,1,1,0
Tulare,4,2022-01-13,6903,6922,3464,3458,27018,27098,13542,13556,81,11,11,10
Tuolumne,4,2022-01-13,875,875,492,383,4416,4429,2497,1932,8,5,5,3
Ventura,4,2022-01-13,15292,15338,10995,4343,82251,82492,59282,23210,267,34,34,43
Yolo,4,2022-01-13,3413,3424,2284,1140,45475,45607,30504,15103,10,5,5,4
Yuba,4,2022-01-13,1105,1108,685,423,4130,4143,2563,1580,28,0,0,6
Alameda,5,2022-01-20,22230,22300,16671,5629,166787,167310,125346,41964,383,38,38,65
Amador,5,2022-01-20,575,575,364,211,3793,3805,2422,1383,8,0,0,3
Butte,5,2022-01-20,2049,2055,1600,455,8800,8829,6881,1948,66,7,7,6
Calaveras,5,2022-01-20,572,572,382,190,2482,2488,1661,827,5,3,3,3
Colusa,5,2022-01-20,162,162,109,53,802,803,545,258,5,0,0,0
Contra Costa,5,2022-01-20,14164,14208,9253,4955,84357,84622,55266,29356,275,22,22,58
Del Norte,5,2022-01-20,278,278,193,85,3708,3720,2588,1132,2,0,0,0
El Dorado,5,2022-01-20,1662,1667,1096,571,7555,7578,4990,2588,17,2,2,8
Fresno,5,2022-01-20,18215,18271,11608,6663,69180,69398,44102,25296,442,37,37,77
Glenn,5,2022-01-20,269,269,184,85,950,952,651,301,1,2,2,0
Humboldt,5,2022-01-20,1041,1044,709,335,7623,7648,5206,2442,21,3,3,2
Imperial,5,2022-01-20,3539,3550,2342,1208,12846,12886,8480,4406,65,15,15,27
Inyo,5,2022-01-20,214,214,155,59,700,700,509,191,2,1,1,0
Kern,5,2022-01-20,11039,11074,7543,3531,51209,51370,35049,16321,258,41,41,55
Kings,5,2022-01-20,4060,4073,2620,1453,16934,16987,10912,6075,41,4,4,3
Lake,5,2022-01-20,688,688,428,260,3443,3454,2142,1312,4,1,1,2
Lassen,5,2022-01-20,387,387,278,109,3530,3540,2535,1005,1,0,0,0
Los Angeles,5,2022-01-20,191639,192239,170679,21560,1593419,1598423,1421037,177386,4052,533,533,740
Madera,5,2022-01-20,2776,2784,1773,1011,11592,11629,7432,4197,36,8,8,8
Marin,5,2022-01-20,2093,2100,1390,710,17294,17348,11541,5807,32,6,6,6
Mariposa,5,2022-01-20,148,148,94,54,992,996,630,366,0,0,0,0
Mendocino,5,2022-01-20,987,990,550,440,4850,4865,2706,2159,25,2,2,3
Merced,5,2022-01-20,3427,3439,2310,1129,12699,12740,8567,4173,49,10,10,10
Modoc,5,2022-01-20,17,17,12,5,113,113,78,35,0,1,1,0
Mono,5,2022-01-20,119,119,69,50,555,555,321,234,1,0,0,0
Monterey,5,2022-01-20,5722,5740,3024,2716,30742,30839,16365,14474,84,8,8,15
Napa,5,2022-01-20,1785,1791,1228,563,11703,11740,8077,3663,23,4,4,6
Nevada,5,2022-01-20,1112,1117,693,424,4980,4996,3106,1890,21,0,0,5
Orange,5,2022-01-20,33978,34084,23360,10724,234199,234934,161747,73187,956,120,120,188
Placer,5,2022-01-20,4008,4020,2442,1578,18729,18787,11442,7345,184,12,12,45
Plumas,5,2022-01-20,207,207,129,78,863,865,539,326,5,0,0,0
Riverside,5,2022-01-20,36332,36445,22919,13526,162827,163337,102952,60385,885,116,116,170
Sacramento,5,2022-01-20,19247,19307,13196,6111,97214,97519,66828,30691,527,59,59,107
San Benito,5,2022-01-20,862,863,629,234,3973,3986,2908,1078,5,1,1,4
San Bernardino,5,2022-01-20,31153,31251,23239,8012,153201,153681,114487,39194,1033,130,130,215
San Diego,5,2022-01-20,56778,56956,49812,7144,251883,252673,221036,31637,1083,116,116,205
San Francisco,5,2022-01-20,9873,9904,5816,4088,90524,90808,53550,37258,235,11,11,39
San Joaquin,5,2022-01-20,11930,11968,7926,4042,58340,58524,38831,19693,236,24,24,66
San Luis Obispo,5,2022-01-20,3728,3741,2683,1058,20959,21024,15104,5920,43,10,10,12
San Mateo,5,2022-01-20,10403,10436,7994,2442,93192,93485,71851,21634,106,13,13,34
Santa Barbara,5,2022-01-20,6684,6705,4584,2121,41770,41901,28688,13213,134,14,14,15
Santa Clara,5,2022-01-20,25040,25118,21867,3251,223633,224336,195655,28681,456,42,42,92
Santa Cruz,5,2022-01-20,4902,4916,3625,1291,41210,41340,30443,10897,36,3,3,3
Shasta,5,2022-01-20,1496,1501,945,556,9527,9556,6028,3528,65,8,8,13
Siskiyou,5,2022-01-20,169,169,123,46,864,866,630,236,1,1,1,1
Solano,5,2022-01-20,5656,5674,3890,1784,33106,33211,22811,10400,139,10,10,25
Sonoma,5,2022-01-20,7261,7284,5010,2274,41512,41643,28702,12941,92,10,10,18
Stanislaus,5,2022-01-20,6953,6974,4051,2923,28201,28290,16469,11821,246,20,20,36
Sutter,5,2022-01-20,1179,1184,783,401,4988,5003,3321,1682,0,2,2,0
Tehama,5,2022-01-20,618,618,342,276,2445,2451,1361,1090,16,4,4,2
Trinity,5,2022-01-20,59,59,35,24,302,302,181,121,0,0,0,0
Tulare,5,2022-01-20,8120,8146,4655,3491,28655,28745,16451,12294,119,10,10,12
Tuolumne,5,2022-01-20,927,929,588,341,3705,3717,2357,1360,12,5,5,2
Ventura,5,2022-01-20,10585,10617,8215,2402,64453,64656,50174,14482,297,38,38,63
Yolo,5,2022-01-20,2511,2519,1839,680,39510,39635,29004,10631,17,4,4,8
Yuba,5,2022-01-20,999,1003,687,316,3733,3745,2570,1175,51,3,3,8
Alameda,6,2022-01-27,14651,14702,11724,2978,152838,153369,122685,30684,372,41,41,78
Amador,6,2022-01-27,413,413,287,126,3646,3658,2539,1119,11,0,0,4
Butte,6,2022-01-27,1438,1443,1188,255,8257,8286,6837,1449,77,8,8,9
Calaveras,6,2022-01-27,389,389,281,108,2088,2094,1524,570,3,3,3,2
Colusa,6,2022-01-27,136,136,99,37,626,627,460,167,4,0,0,0
Contra Costa,6,2022-01-27,9719,9751,6947,2804,76029,76292,54610,21682,253,26,26,63
Del Norte,6,2022-01-27,370,370,278,92,4205,4220,3179,1041,3,0,0,3
El Dorado,6,2022-01-27,969,972,697,275,6392,6414,4620,1794,21,6,6,4
Fresno,6,2022-01-27,13434,13480,9408,4072,61867,62081,43427,18654,496,35,35,94
Glenn,6,2022-01-27,218,218,162,56,789,790,586,204,4,0,0,0
Humboldt,6,2022-01-27,687,687,507,180,6731,6755,5003,1752,22,1,1,5
Imperial,6,2022-01-27,2853,2864,2058,806,12720,12765,9192,3573,76,17,17,28
Inyo,6,2022-01-27,80,80,62,18,537,538,421,117,3,0,0,0
Kern,6,2022-01-27,7484,7510,5541,1969,46156,46316,34319,11997,266,43,43,46
Kings,6,2022-01-27,3050,3061,2152,909,16321,16378,11548,4830,42,2,2,4
Lake,6,2022-01-27,627,628,430,198,3370,3380,2329,1051,10,4,4,5
Lassen,6,2022-01-27,338,338,259,79,3576,3589,2764,825,6,0,0,0
Los Angeles,6,2022-01-27,107480,107850,98452,9398,1414258,1419171,1297897,121274,3426,598,598,766
Madera,6,2022-01-27,2161,2168,1516,652,10460,10497,7373,3124,39,4,4,15
Marin,6,2022-01-27,1441,1447,1045,402,15155,15206,11034,4172,42,3,3,12
Mariposa,6,2022-01-27,112,112,78,34,871,874,610,264,0,0,0,0
Mendocino,6,2022-01-27,624,624,388,236,3920,3933,2454,1479,15,3,3,3
Merced,6,2022-01-27,2524,2533,1856,677,11530,11571,8483,3088,51,10,10,13
Modoc,6,2022-01-27,12,12,9,3,101,101,76,25,2,0,0,0
Mono,6,2022-01-27,54,54,35,19,344,344,223,121,0,0,0,0
Monterey,6,2022-01-27,4275,4290,2568,1722,28303,28403,17054,11349,97,6,6,15
Napa,6,2022-01-27,1275,1280,951,329,10621,10658,7944,2714,18,4,4,7
Nevada,6,2022-01-27,811,812,556,256,4443,4459,3070,1389,28,4,4,4
Orange,6,2022-01-27,17740,17800,13224,4576,199432,200123,149498,50625,844,186,186,178
Placer,6,2022-01-27,2932,2942,1980,962,16579,16635,11239,5396,202,13,13,49
Plumas,6,2022-01-27,174,174,119,55,774,778,533,245,5,0,0,0
Riverside,6,2022-01-27,22944,23022,15924,7098,135789,136259,94697,41562,833,116,116,171
Sacramento,6,2022-01-27,13453,13498,10016,3482,85694,85991,63981,22010,503,81,81,96
San Benito,6,2022-01-27,596,596,465,131,3545,3558,2785,773,6,0,0,3
San Bernardino,6,2022-01-27,18779,18843,14951,3892,129883,130332,103747,26585,889,163,163,230
San Diego,6,2022-01-27,35341,35462,31984,3478,212037,212770,192110,20660,1040,116,116,213
San Francisco,6,2022-01-27,5998,6018,3937,2081,79153,79428,52274,27154,233,21,21,45
San Joaquin,6,2022-01-27,7584,7611,5492,2119,48362,48530,35165,13365,238,31,31,80
San Luis Obispo,6,2022-01-27,2585,2593,1997,596,18252,18315,14143,4172,48,9,9,9
San Mateo,6,2022-01-27,6067,6087,4951,1136,84332,84625,69075,15550,127,16,16,31
Santa Barbara,6,2022-01-27,4956,4973,3683,1290,38064,38195,28382,9813,108,17,17,17
Santa Clara,6,2022-01-27,17697,17758,15975,1783,215140,215889,194620,21269,460,39,39,85
Santa Cruz,6,2022-01-27,4304,4319,3395,924,49867,50039,39399,10640,46,4,4,0
Shasta,6,2022-01-27,1169,1174,812,362,8962,8994,6249,2745,78,7,7,11
Siskiyou,6,2022-01-27,114,114,89,25,679,681,531,150,10,2,2,2
Solano,6,2022-01-27,4321,4336,3233,1103,30461,30567,22836,7731,143,12,12,27
Sonoma,6,2022-01-27,5107,5124,3810,1314,36491,36617,27349,9268,87,9,9,15
Stanislaus,6,2022-01-27,4753,4770,3086,1684,24194,24278,15780,8498,284,22,22,46
Sutter,6,2022-01-27,805,807,582,225,4230,4245,3071,1174,0,1,1,0
Tehama,6,2022-01-27,433,433,269,164,2290,2296,1433,863,21,4,4,4
Trinity,6,2022-01-27,46,46,30,16,264,264,175,89,0,0,0,0
Tulare,6,2022-01-27,5949,5969,3814,2155,25650,25739,16493,9246,141,15,15,18
Tuolumne,6,2022-01-27,968,971,679,292,3704,3717,2602,1115,13,3,3,2
Ventura,6,2022-01-27,6662,6686,5474,1212,58989,59194,48632,10562,268,33,33,58
Yolo,6,2022-01-27,1775,1782,1395,387,37547,37678,29584,8094,17,8,8,7
Yuba,6,2022-01-27,671,671,498,173,3254,3266,2430,836,58,2,2,8
Alameda,7,2022-02-03,8098,8130,6837,1293,126463,126962,107122,19840,306,48,48,69
Amador,7,2022-02-03,276,276,208,68,3206,3219,2429,790,12,3,3,4
Butte,7,2022-02-03,924,928,800,128,6814,6841,5909,932,82,2,2,8
Calaveras,7,2022-02-03,214,214,168,46,1676,1682,1315,367,1,5,5,2
Colusa,7,2022-02-03,91,91,72,19,626,628,492,136,5,0,0,0
Contra Costa,7,2022-02-03,5122,5142,3955,1187,61120,61360,47366,13994,208,37,37,63
Del Norte,7,2022-02-03,247,247,197,50,3908,3924,3152,772,2,2,2,1
El Dorado,7,2022-02-03,549,549,424,125,5437,5457,4232,1225,15,0,0,5
Fresno,7,2022-02-03,8188,8220,6210,2010,48501,48691,36890,11801,510,43,43,101
Glenn,7,2022-02-03,156,156,124,32,684,685,544,141,4,0,0,0
Humboldt,7,2022-02-03,515,515,408,107,5151,5172,4104,1068,15,3,3,2
Imperial,7,2022-02-03,1467,1472,1138,334,9506,9543,7389,2154,61,17,17,24
Inyo,7,2022-02-03,57,57,47,10,445,446,370,76,4,3,3,0
Kern,7,2022-02-03,4417,4434,3511,923,38129,38280,30386,7894,230,43,43,55
Kings,7,2022-02-03,1748,1753,1332,421,11175,11218,8552,2666,56,8,8,6
Lake,7,2022-02-03,395,395,294,101,2797,2808,2097,711,6,3,3,4
Lassen,7,2022-02-03,218,218,177,41,3232,3245,2649,596,6,3,3,0
Los Angeles,7,2022-02-03,52596,52801,49306,3495,1222629,1227447,1148003,79444,2581,679,679,652
Madera,7,2022-02-03,1349,1354,1027,327,8620,8655,6587,2068,43,6,6,11
Marin,7,2022-02-03,812,814,633,181,12797,12847,10032,2815,27,7,7,8
Mariposa,7,2022-02-03,75,75,56,19,718,720,542,178,0,2,2,0
Mendocino,7,2022-02-03,373,373,257,116,3091,3105,2147,958,10,1,1,7
Merced,7,2022-02-03,1467,1472,1156,316,8916,8953,7041,1912,63,11,11,11
Modoc,7,2022-02-03,22,22,18,4,134,134,108,26,1,0,0,0
Mono,7,2022-02-03,49,49,35,14,302,302,215,87,0,0,0,0
Monterey,7,2022-02-03,2828,2840,1893,947,24510,24605,16458,8147,77,10,10,13
Napa,7,2022-02-03,848,851,677,174,8538,8572,6842,1730,20,7,7,3
Nevada,7,2022-02-03,431,431,322,109,3391,3405,2549,856,34,1,1,4
Orange,7,2022-02-03,8671,8704,6929,1775,162337,162976,130312,32664,612,135,135,134
Placer,7,2022-02-03,1730,1737,1274,463,13638,13692,10081,3611,147,23,23,41
Plumas,7,2022-02-03,98,98,73,25,625,626,465,161,0,1,1,0
Riverside,7,2022-02-03,11079,11122,8350,2772,106340,106758,80490,26268,695,107,107,137
Sacramento,7,2022-02-03,7525,7554,6001,1553,69528,69802,55586,14216,480,74,74,96
San Benito,7,2022-02-03,364,364,301,63,2910,2922,2421,501,5,2,2,4
San Bernardino,7,2022-02-03,9298,9334,7820,1514,101516,101916,85579,16337,643,157,157,179
San Diego,7,2022-02-03,17812,17882,16547,1335,163128,163770,151705,12065,815,92,92,199
San Francisco,7,2022-02-03,2927,2939,2114,825,61194,61434,44308,17126,192,25,25,53
San Joaquin,7,2022-02-03,4245,4261,3313,948,39001,39154,30551,8603,197,43,43,67
San Luis Obispo,7,2022-02-03,1526,1532,1254,278,13879,13933,11424,2509,38,16,16,8
San Mateo,7,2022-02-03,3199,3211,2744,467,67064,67327,57678,9649,129,13,13,18
Santa Barbara,7,2022-02-03,2922,2934,2330,604,34411,34546,27511,7035,101,17,17,17
Santa Clara,7,2022-02-03,10494,10536,9725,811,187225,187964,173797,14167,406,41,41,80
Santa Cruz,7,2022-02-03,2419,2429,2017,412,45667,45847,38132,7715,25,3,3,7
Shasta,7,2022-02-03,765,768,577,191,7479,7509,5655,1854,61,18,18,14
Siskiyou,7,2022-02-03,111,111,91,20,716,719,593,126,4,4,4,0
Solano,7,2022-02-03,3190,3202,2548,654,26803,26907,21477,5430,104,5,5,28
Sonoma,7,2022-02-03,2526,2536,2020,516,28998,29113,23283,5830,79,8,8,16
Stanislaus,7,2022-02-03,3049,3062,2182,880,20563,20645,14747,5898,258,38,38,43
Sutter,7,2022-02-03,502,502,390,112,3624,3638,2836,802,0,5,5,0
Tehama,7,2022-02-03,366,366,253,113,1837,1844,1273,571,18,2,2,5
Trinity,7,2022-02-03,34,34,24,10,172,172,125,47,0,0,0,0
Tulare,7,2022-02-03,3486,3500,2460,1040,19789,19866,14004,5862,138,21,21,24
Tuolumne,7,2022-02-03,437,437,331,106,2736,2747,2083,664,17,2,2,1
Ventura,7,2022-02-03,3457,3470,2981,489,46002,46183,39763,6420,229,38,38,40
Yolo,7,2022-02-03,967,971,805,166,34307,34442,28580,5862,14,7,7,7
Yuba,7,2022-02-03,438,438,348,90,2633,2645,2106,539,65,2,2,12
Alameda,8,2022-02-10,4439,4458,3910,548,106996,107459,94456,13003,228,39,39,63
Amador,8,2022-02-10,124,124,99,25,2583,2593,2088,505,14,2,2,4
Butte,8,2022-02-10,614,615,550,65,5819,5844,5232,612,68,8,8,10
Calaveras,8,2022-02-10,140,140,116,24,1393,1398,1159,239,6,1,1,1
Colusa,8,2022-02-10,56,56,46,10,518,520,431,89,2,0,0,0
Contra Costa,8,2022-02-10,3051,3064,2505,559,48774,48985,40176,8809,150,26,26,40
Del Norte,8,2022-02-10,269,269,226,43,3833,3851,3254,597,7,0,0,2
El Dorado,8,2022-02-10,347,347,284,63,4758,4778,3933,845,18,3,3,2
Fresno,8,2022-02-10,4798,4819,3885,934,39112,39280,31735,7545,431,51,51,86
Glenn,8,2022-02-10,77,77,64,13,516,517,433,84,4,1,1,0
Humboldt,8,2022-02-10,418,418,349,69,4676,4697,3936,761,24,1,1,2
Imperial,8,2022-02-10,812,815,669,146,7214,7245,5955,1290,47,13,13,22
Inyo,8,2022-02-10,27,27,23,4,426,427,370,57,2,0,0,0
Kern,8,2022-02-10,2634,2645,2212,433,31202,31336,26264,5072,159,31,31,41
Kings,8,2022-02-10,1000,1005,814,191,9015,9054,7346,1708,51,16,16,6
Lake,8,2022-02-10,278,278,221,57,2519,2531,2020,511,9,0,0,4
Lassen,8,2022-02-10,136,136,116,20,3115,3128,2681,447,5,0,0,0
Los Angeles,8,2022-02-10,28193,28314,26904,1410,1112713,1117543,1062960,54583,1838,556,556,469
Madera,8,2022-02-10,791,794,641,153,7255,7287,5903,1384,37,2,2,9
Marin,8,2022-02-10,497,497,410,87,10682,10729,8886,1843,30,7,7,9
Mariposa,8,2022-02-10,33,33,26,7,489,490,394,96,0,0,0,0
Mendocino,8,2022-02-10,271,271,203,68,2606,2617,1965,652,10,2,2,6
Merced,8,2022-02-10,905,909,755,154,7519,7550,6285,1265,46,16,16,6
Modoc,8,2022-02-10,21,21,18,3,218,218,183,35,4,0,0,0
Mono,8,2022-02-10,18,18,14,4,211,211,162,49,0,0,0,0
Monterey,8,2022-02-10,1618,1625,1183,442,19817,19902,14545,5357,60,15,15,18
Napa,8,2022-02-10,559,561,470,91,7061,7090,5969,1121,16,4,4,3
Nevada,8,2022-02-10,242,242,192,50,2851,2864,2289,575,18,1,1,3
Orange,8,2022-02-10,4946,4967,4174,793,147387,148026,124828,23198,436,106,106,102
Placer,8,2022-02-10,929,933,733,200,11011,11059,8737,2322,136,16,16,25
Plumas,8,2022-02-10,62,62,49,13,449,450,357,93,1,0,0,0
Riverside,8,2022-02-10,6156,6183,4959,1224,83566,83927,67546,16381,455,100,100,110
Sacramento,8,2022-02-10,4651,4672,3913,759,58000,58253,48947,9306,351,62,62,89
San Benito,8,2022-02-10,232,232,201,31,2413,2423,2100,323,5,0,0,4
San Bernardino,8,2022-02-10,5143,5164,4514,650,81217,81569,71454,10115,459,98,98,141
San Diego,8,2022-02-10,10814,10861,10246,615,137721,138317,130569,7748,666,97,97,171
San Francisco,8,2022-02-10,2069,2077,1609,468,51000,51220,39792,11428,166,25,25,37
San Joaquin,8,2022-02-10,2522,2533,2087,446,33913,34061,28154,5907,151,37,37,66
San Luis Obispo,8,2022-02-10,1003,1008,866,142,11387,11436,9831,1605,24,11,11,9
San Mateo,8,2022-02-10,1800,1807,1603,204,58505,58759,52271,6488,67,16,16,15
Santa Barbara,8,2022-02-10,1522,1529,1278,251,25109,25218,21166,4052,81,13,13,15
Santa Clara,8,2022-02-10,6136,6163,5803,360,163682,164392,155019,9373,321,31,31,59
Santa Cruz,8,2022-02-10,1483,1489,1293,196,36064,36220,31542,4678,35,4,4,3
Shasta,8,2022-02-10,572,573,459,114,6424,6451,5187,1264,62,14,14,11
Siskiyou,8,2022-02-10,86,86,74,12,609,610,526,84,2,1,1,2
Solano,8,2022-02-10,1574,1580,1328,252,21958,22052,18575,3477,82,2,2,19
Sonoma,8,2022-02-10,1600,1607,1349,258,24491,24596,20730,3866,44,10,10,16
Stanislaus,8,2022-02-10,1912,1921,1475,446,16998,17072,13154,3918,215,26,26,48
Sutter,8,2022-02-10,262,262,216,46,3034,3048,2518,530,0,6,6,0
Tehama,8,2022-02-10,197,197,147,50,1421,1427,1071,356,9,6,6,5
Trinity,8,2022-02-10,20,20,16,4,137,137,107,30,0,0,0,0
Tulare,8,2022-02-10,2063,2073,1575,498,16279,16349,12475,3874,121,25,25,22
Tuolumne,8,2022-02-10,238,238,192,46,2420,2431,1964,467,11,1,1,4
Ventura,8,2022-02-10,2043,2052,1828,224,39261,39430,35211,4219,177,44,44,46
Yolo,8,2022-02-10,685,686,594,92,29380,29507,25612,3895,11,8,8,3
Yuba,8,2022-02-10,268,268,225,43,2251,2262,1900,362,28,1,1,13
Alameda,9,2022-02-17,2638,2651,2400,251,93823,94279,85532,8747,183,31,31,38
Amador,9,2022-02-17,103,103,87,16,2183,2194,1860,334,6,3,3,3
Butte,9,2022-02-17,346,346,318,28,4790,4813,4429,384,62,15,15,8
Calaveras,9,2022-02-17,53,53,46,7,983,988,857,131,3,2,2,2
Colusa,9,2022-02-17,32,32,28,4,398,399,346,53,5,0,0,0
Contra Costa,9,2022-02-17,1907,1916,1643,273,42089,42294,36373,5921,107,19,19,31
Del Norte,9,2022-02-17,167,167,146,21,3091,3106,2734,372,6,0,0,2
El Dorado,9,2022-02-17,198,198,170,28,4096,4116,3548,568,14,3,3,4
Fresno,9,2022-02-17,2873,2887,2447,440,31924,32078,27265,4813,353,24,24,60
Glenn,9,2022-02-17,39,39,34,5,407,408,357,51,3,0,0,0
Humboldt,9,2022-02-17,259,259,226,33,3868,3888,3400,488,19,2,2,4
Imperial,9,2022-02-17,460,460,396,64,5425,5450,4697,753,43,7,7,15
Inyo,9,2022-02-17,18,18,16,2,375,376,338,38,1,0,0,0
Kern,9,2022-02-17,1607,1615,1409,206,26307,26435,23127,3308,118,28,28,33
Kings,9,2022-02-17,569,572,487,85,7065,7099,6057,1042,34,6,6,5
Lake,9,2022-02-17,235,235,197,38,2215,2226,1875,351,7,3,3,2
Lassen,9,2022-02-17,167,167,148,19,2554,2565,2281,284,2,2,2,0
Los Angeles,9,2022-02-17,16081,16158,15550,608,1005588,1010478,973351,37127,1274,397,397,342
Madera,9,2022-02-17,489,490,416,74,6371,6402,5454,948,35,3,3,9
Marin,9,2022-02-17,309,309,267,42,10016,10065,8721,1344,18,2,2,6
Mariposa,9,2022-02-17,24,24,20,4,408,408,346,62,0,0,0,0
Mendocino,9,2022-02-17,152,152,121,31,2160,2171,1740,431,11,2,2,2
Merced,9,2022-02-17,612,614,533,81,6225,6256,5441,815,32,10,10,8
Modoc,9,2022-02-17,12,12,11,1,65,65,57,8,0,0,0,0
Mono,9,2022-02-17,9,9,7,2,173,173,142,31,0,0,0,0
Monterey,9,2022-02-17,1019,1025,803,222,15418,15492,12166,3326,55,7,7,7
Napa,9,2022-02-17,349,349,305,44,5839,5867,5146,721,8,4,4,3
Nevada,9,2022-02-17,149,149,125,24,2413,2426,2045,381,13,2,2,6
Orange,9,2022-02-17,3294,3309,2898,411,128847,129475,113896,15579,286,94,94,77
Placer,9,2022-02-17,441,441,367,74,9544,9590,8011,1579,100,10,10,20
Plumas,9,2022-02-17,26,26,22,4,413,414,347,67,0,0,0,0
Riverside,9,2022-02-17,3556,3573,3017,556,69396,69732,59102,10630,313,68,68,78
Sacramento,9,2022-02-17,2650,2662,2327,335,50277,50522,44271,6251,304,43,43,55
San Benito,9,2022-02-17,141,141,127,14,2092,2102,1888,214,2,1,1,2
San Bernardino,9,2022-02-17,2696,2709,2446,263,67516,67843,61394,6449,301,86,86,105
San Diego,9,2022-02-17,6330,6361,6089,272,117765,118337,113340,4997,525,73,73,123
San Francisco,9,2022-02-17,1243,1250,1028,222,46444,46670,38477,8193,120,20,20,33
San Joaquin,9,2022-02-17,1549,1557,1342,215,28433,28572,24725,3847,102,30,30,48
San Luis Obispo,9,2022-02-17,600,602,536,66,9338,9384,8371,1013,21,12,12,5
San Mateo,9,2022-02-17,1077,1083,989,94,51896,52148,47744,4404,58,10,10,13
Santa Barbara,9,2022-02-17,880,884,772,112,22445,22554,19757,2797,57,9,9,13
Santa Clara,9,2022-02-17,3499,3516,3361,155,145579,146287,139994,6293,271,29,29,56
Santa Cruz,9,2022-02-17,786,790,711,79,30077,30223,27241,2982,23,1,1,5
Shasta,9,2022-02-17,376,376,317,59,5477,5504,4661,843,63,9,9,14
Siskiyou,9,2022-02-17,57,57,51,6,530,531,475,56,8,2,2,5
Solano,9,2022-02-17,940,946,829,117,17138,17221,15123,2098,62,2,2,20
Sonoma,9,2022-02-17,884,890,780,110,19747,19842,17432,2410,43,2,2,7
Stanislaus,9,2022-02-17,1041,1047,855,192,14025,14094,11542,2552,175,32,32,42
Sutter,9,2022-02-17,192,192,165,27,2590,2603,2249,354,0,2,2,0
Tehama,9,2022-02-17,145,145,116,29,1336,1341,1074,267,13,4,4,4
Trinity,9,2022-02-17,17,17,14,3,212,212,175,37,0,0,0,0
Tulare,9,2022-02-17,1126,1132,917,215,13824,13891,11269,2622,100,23,23,15
Tuolumne,9,2022-02-17,143,143,121,22,2019,2028,1722,306,11,6,6,2
Ventura,9,2022-02-17,1209,1216,1114,102,32770,32930,30231,2699,126,20,20,26
Yolo,9,2022-02-17,380,380,341,39,25226,25347,22766,2581,8,4,4,4
Yuba,9,2022-02-17,178,178,156,22,1832,1841,1611,230,19,1,1,11
Alameda,10,2022-02-24,1592,1600,1485,115,70077,70447,65483,4964,103,23,23,31
Amador,10,2022-02-24,61,61,54,7,1894,1903,1679,224,9,3,3,2
Butte,10,2022-02-24,216,216,203,13,3952,3972,3731,241,45,8,8,4
Calaveras,10,2022-02-24,44,44,39,5,1013,1017,914,103,1,7,7,0
Colusa,10,2022-02-24,15,15,13,2,352,354,318,36,5,0,0,0
Contra Costa,10,2022-02-24,1055,1062,946,116,31618,31785,28368,3417,62,15,15,18
Del Norte,10,2022-02-24,95,95,86,9,2666,2681,2435,246,6,1,1,2
El Dorado,10,2022-02-24,129,129,115,14,3376,3393,3032,361,5,1,1,6
Fresno,10,2022-02-24,1529,1537,1356,181,25531,25666,22697,2969,247,27,27,48
Glenn,10,2022-02-24,20,20,18,2,381,382,345,37,1,0,0,0
Humboldt,10,2022-02-24,166,166,150,16,2900,2916,2633,283,13,1,1,1
Imperial,10,2022-02-24,307,307,274,33,4742,4766,4258,508,29,6,6,9
Inyo,10,2022-02-24,10,10,9,1,331,332,306,26,0,0,0,0
Kern,10,2022-02-24,941,948,855,93,22715,22834,20635,2199,88,15,15,23
Kings,10,2022-02-24,366,366,323,43,6226,6258,5542,716,24,6,6,4
Lake,10,2022-02-24,139,139,121,18,1856,1866,1637,229,3,3,3,1
Lassen,10,2022-02-24,82,82,75,7,2032,2042,1869,173,0,2,2,0
Los Angeles,10,2022-02-24,9586,9636,9365,271,908912,913704,888709,24995,875,260,260,230
Madera,10,2022-02-24,225,225,199,26,4125,4147,3673,474,29,3,3,6
Marin,10,2022-02-24,156,156,140,16,7532,7572,6788,784,12,4,4,4
Mariposa,10,2022-02-24,30,30,27,3,346,346,305,41,0,1,1,0
Mendocino,10,2022-02-24,96,96,81,15,1839,1849,1559,290,10,2,2,1
Merced,10,2022-02-24,339,339,304,35,4886,4910,4418,492,26,11,11,4
Modoc,10,2022-02-24,6,6,5,1,56,56,51,5,1,0,0,0
Mono,10,2022-02-24,5,5,4,1,162,162,139,23,0,1,1,0
Monterey,10,2022-02-24,519,520,429,91,13056,13124,10910,2214,38,8,8,9
Napa,10,2022-02-24,172,172,156,16,4980,5006,4535,471,2,3,3,3
Nevada,10,2022-02-24,73,73,64,9,1972,1983,1742,241,11,1,1,3
Orange,10,2022-02-24,2045,2057,1862,195,107740,108309,98347,9962,239,54,54,56
Placer,10,2022-02-24,286,286,249,37,8116,8158,7113,1045,82,6,6,15
Plumas,10,2022-02-24,25,25,22,3,316,316,276,40,1,0,0,0
Riverside,10,2022-02-24,1948,1958,1724,234,60115,60429,53314,7115,236,36,36,53
Sacramento,10,2022-02-24,1419,1426,1287,139,42001,42222,38225,3997,219,33,33,39
San Benito,10,2022-02-24,66,66,61,5,1611,1619,1493,126,0,0,0,2
San Bernardino,10,2022-02-24,1461,1469,1360,109,57771,58075,53869,4206,192,52,52,58
San Diego,10,2022-02-24,3702,3721,3602,119,94463,94959,91958,3001,406,44,44,91
San Francisco,10,2022-02-24,886,891,768,123,37429,37625,32477,5148,85,14,14,22
San Joaquin,10,2022-02-24,790,794,710,84,24014,24141,21648,2493,70,19,19,29
San Luis Obispo,10,2022-02-24,389,390,357,33,7487,7527,6906,621,16,13,13,2
San Mateo,10,2022-02-24,552,553,517,36,36138,36328,33996,2332,44,8,8,5
Santa Barbara,10,2022-02-24,455,456,412,44,19126,19227,17402,1825,39,5,5,11
Santa Clara,10,2022-02-24,1945,1954,1889,65,88816,89282,86375,2907,201,25,25,57
Santa Cruz,10,2022-02-24,479,480,443,37,23480,23605,21841,1764,16,2,2,5
Shasta,10,2022-02-24,184,184,162,22,4674,4698,4140,558,39,10,10,9
Siskiyou,10,2022-02-24,38,38,35,3,412,413,379,34,5,3,3,0
Solano,10,2022-02-24,534,535,485,50,14671,14748,13375,1373,48,5,5,15
Sonoma,10,2022-02-24,485,486,440,46,15008,15087,13684,1403,31,3,3,5
Stanislaus,10,2022-02-24,560,562,482,80,12178,12242,10522,1720,146,16,16,27
Sutter,10,2022-02-24,106,106,95,11,2095,2107,1888,219,0,1,1,0
Tehama,10,2022-02-24,70,70,59,11,1103,1108,935,173,11,7,7,3
Trinity,10,2022-02-24,7,7,6,1,142,142,122,20,0,0,0,0
Tulare,10,2022-02-24,571,574,489,85,11016,11073,9460,1613,71,16,16,13
Tuolumne,10,2022-02-24,86,86,76,10,1508,1515,1338,177,7,3,3,2
Ventura,10,2022-02-24,716,719,673,46,27377,27520,25819,1701,83,20,20,20
Yolo,10,2022-02-24,241,241,222,19,22248,22364,20643,1721,3,1,1,5
Yuba,10,2022-02-24,86,86,78,8,1704,1714,1550,164,19,0,0,7
Alameda,11,2022-03-03,1283,1291,1221,70,75084,75537,71493,4044,107,8,8,25
Amador,11,2022-03-03,89,89,81,8,1676,1685,1530,155,6,1,1,1
Butte,11,2022-03-03,144,144,137,7,3724,3746,3573,173,33,5,5,1
Calaveras,11,2022-03-03,20,20,18,2,1122,1129,1040,89,1,2,2,0
Colusa,11,2022-03-03,9,9,8,1,353,354,326,28,7,0,0,0
Contra Costa,11,2022-03-03,724,729,668,61,32510,32705,30003,2702,54,14,14,11
Del Norte,11,2022-03-03,62,62,57,5,1925,1937,1799,138,4,2,2,1
El Dorado,11,2022-03-03,93,93,85,8,3369,3389,3111,278,3,3,3,5
Fresno,11,2022-03-03,1056,1063,967,96,23594,23735,21619,2116,179,25,25,38
Glenn,11,2022-03-03,13,13,12,1,384,385,357,28,1,0,0,0
Humboldt,11,2022-03-03,122,122,113,9,3001,3020,2798,222,9,1,1,2
Imperial,11,2022-03-03,207,207,190,17,4531,4559,4187,372,11,6,6,11
Inyo,11,2022-03-03,10,10,9,1,360,362,340,22,0,0,0,0
Kern,11,2022-03-03,615,618,571,47,22035,22167,20528,1639,66,12,12,16
Kings,11,2022-03-03,173,173,158,15,5461,5494,5013,481,14,3,3,2
Lake,11,2022-03-03,96,96,87,9,1825,1835,1662,173,0,3,3,2
Lassen,11,2022-03-03,80,80,75,5,1882,1895,1772,123,0,1,1,0
Los Angeles,11,2022-03-03,6632,6671,6530,141,919216,924767,905571,19196,676,200,200,141
Madera,11,2022-03-03,151,151,137,14,4181,4206,3835,371,16,0,0,5
Marin,11,2022-03-03,155,155,143,12,7978,8027,7397,630,12,2,2,1
Mariposa,11,2022-03-03,17,17,15,2,327,327,297,30,0,1,1,0
Mendocino,11,2022-03-03,67,67,59,8,1798,1810,1591,219,5,1,1,3
Merced,11,2022-03-03,233,233,215,18,4756,4785,4420,365,22,4,4,6
Modoc,11,2022-03-03,2,2,2,0,52,52,48,4,0,0,0,0
Mono,11,2022-03-03,4,4,4,0,139,139,123,16,0,0,0,0
Monterey,11,2022-03-03,300,300,260,40,12044,12117,10520,1597,17,9,9,4
Napa,11,2022-03-03,212,212,197,15,5161,5192,4817,375,8,2,2,2
Nevada,11,2022-03-03,62,62,56,6,1847,1859,1685,174,7,0,0,0
Orange,11,2022-03-03,1423,1431,1328,103,113500,114185,106042,8143,169,36,36,33
Placer,11,2022-03-03,197,197,177,20,7947,7994,7207,787,68,4,4,14
Plumas,11,2022-03-03,10,10,9,1,316,317,285,32,0,0,0,0
Riverside,11,2022-03-03,1286,1293,1173,120,56576,56916,51750,5166,155,47,47,36
Sacramento,11,2022-03-03,938,945,875,70,40936,41184,38199,2985,144,16,16,29
San Benito,11,2022-03-03,43,43,40,3,1578,1588,1494,94,0,1,1,2
San Bernardino,11,2022-03-03,1012,1019,962,57,55344,55675,52608,3067,122,31,31,51
San Diego,11,2022-03-03,2664,2679,2615,64,96661,97244,94932,2312,309,33,33,68
San Francisco,11,2022-03-03,750,755,674,81,39191,39427,35270,4157,69,11,11,15
San Joaquin,11,2022-03-03,526,529,486,43,21756,21886,20147,1739,50,10,10,15
San Luis Obispo,11,2022-03-03,289,290,272,18,7767,7813,7318,495,6,4,4,0
San Mateo,11,2022-03-03,586,590,561,29,42405,42661,40595,2066,40,2,2,6
Santa Barbara,11,2022-03-03,277,277,256,21,18693,18804,17429,1375,28,2,2,10
Santa Clara,11,2022-03-03,1605,1615,1575,40,114596,115292,112510,2782,167,11,11,42
Santa Cruz,11,2022-03-03,389,389,366,23,25216,25367,23912,1455,16,1,1,4
Shasta,11,2022-03-03,149,149,135,14,4889,4920,4472,448,36,13,13,7
Siskiyou,11,2022-03-03,17,17,16,1,436,437,410,27,3,1,1,1
Solano,11,2022-03-03,412,412,382,30,14521,14609,13569,1040,45,1,1,14
Sonoma,11,2022-03-03,402,402,373,29,15600,15693,14574,1119,18,5,5,8
Stanislaus,11,2022-03-03,369,369,328,41,11478,11547,10286,1261,108,10,10,17
Sutter,11,2022-03-03,98,98,90,8,2159,2172,1997,175,0,2,2,0
Tehama,11,2022-03-03,51,51,45,6,1162,1168,1026,142,6,1,1,2
Trinity,11,2022-03-03,7,7,6,1,104,104,93,11,0,0,0,0
Tulare,11,2022-03-03,372,373,330,43,10549,10613,9411,1202,54,8,8,6
Tuolumne,11,2022-03-03,52,52,47,5,1295,1301,1184,117,5,3,3,1
Ventura,11,2022-03-03,445,446,425,21,27548,27714,26413,1301,51,5,5,12
Yolo,11,2022-03-03,169,169,159,10,23314,23454,22068,1386,4,3,3,4
Yuba,11,2022-03-03,78,78,72,6,1666,1676,1554,122,11,0,0,6
Alameda,12,2022-03-10,994,1001,960,41,69546,70040,67212,2828,82,11,11,12
Amador,12,2022-03-10,31,31,29,2,1416,1427,1328,99,4,1,1,1
Butte,12,2022-03-10,77,77,74,3,3534,3560,3437,123,23,3,3,4
Calaveras,12,2022-03-10,29,29,27,2,1071,1078,1014,64,0,1,1,0
Colusa,12,2022-03-10,8,8,8,0,325,326,306,20,5,0,0,0
Contra Costa,12,2022-03-10,594,598,560,38,29219,29425,27576,1849,36,4,4,10
Del Norte,12,2022-03-10,48,48,45,3,1546,1557,1472,85,5,1,1,2
El Dorado,12,2022-03-10,59,59,55,4,3013,3034,2845,189,2,0,0,4
Fresno,12,2022-03-10,676,681,634,47,21843,21998,20508,1490,135,15,15,22
Glenn,12,2022-03-10,18,18,17,1,329,330,312,18,1,0,0,0
Humboldt,12,2022-03-10,66,66,62,4,2909,2930,2766,164,3,3,3,2
Imperial,12,2022-03-10,94,94,88,6,4765,4800,4503,297,6,1,1,9
Inyo,12,2022-03-10,10,10,10,0,171,171,163,8,1,0,0,0
Kern,12,2022-03-10,371,371,350,21,20127,20269,19136,1133,58,13,13,13
Kings,12,2022-03-10,204,204,190,14,4776,4811,4493,318,16,4,4,2
Lake,12,2022-03-10,58,58,54,4,1688,1700,1578,122,0,1,1,0
Lassen,12,2022-03-10,34,34,32,2,1570,1582,1504,78,0,0,0,0
Los Angeles,12,2022-03-10,4664,4697,4623,74,853926,859993,846696,13297,480,154,154,108
Madera,12,2022-03-10,98,98,91,7,3804,3831,3574,257,10,1,1,3
Marin,12,2022-03-10,181,181,170,11,6508,6555,6162,393,9,1,1,0
Mariposa,12,2022-03-10,13,13,12,1,245,245,228,17,0,1,1,0
Mendocino,12,2022-03-10,48,48,43,5,1525,1538,1395,143,3,0,0,0
Merced,12,2022-03-10,146,146,137,9,4166,4195,3952,243,21,5,5,4
Modoc,12,2022-03-10,2,2,2,0,57,57,54,3,0,0,0,0
Mono,12,2022-03-10,2,2,2,0,113,113,103,10,0,0,0,0
Monterey,12,2022-03-10,193,193,173,20,10596,10671,9591,1080,18,3,3,2
Napa,12,2022-03-10,167,167,158,9,4432,4465,4220,245,5,0,0,3
Nevada,12,2022-03-10,51,51,47,4,1564,1575,1462,113,5,1,1,0
Orange,12,2022-03-10,1039,1046,988,58,102967,103698,98111,5587,135,28,28,28
Placer,12,2022-03-10,159,159,147,12,7380,7432,6872,560,61,5,5,9
Plumas,12,2022-03-10,8,8,7,1,282,283,262,21,0,0,0,0
Riverside,12,2022-03-10,813,820,762,58,52458,52831,49189,3642,110,15,15,17
Sacramento,12,2022-03-10,661,666,629,37,37569,37836,35753,2083,120,17,17,19
San Benito,12,2022-03-10,32,32,31,1,1446,1457,1392,65,0,1,1,2
San Bernardino,12,2022-03-10,663,669,641,28,52229,52599,50417,2182,89,18,18,35
San Diego,12,2022-03-10,2162,2177,2138,39,97971,98663,96907,1756,198,25,25,55
San Francisco,12,2022-03-10,600,604,555,49,35247,35497,32635,2862,52,4,4,10
San Joaquin,12,2022-03-10,357,358,336,22,20346,20489,19253,1236,25,8,8,15
San Luis Obispo,12,2022-03-10,195,195,185,10,7139,7190,6846,344,4,9,9,0
San Mateo,12,2022-03-10,487,490,472,18,37640,37907,36524,1383,25,1,1,5
Santa Barbara,12,2022-03-10,183,183,173,10,17688,17814,16830,984,14,7,7,7
Santa Clara,12,2022-03-10,1232,1241,1218,23,102688,103416,101535,1881,123,16,16,32
Santa Cruz,12,2022-03-10,270,270,258,12,23487,23654,22628,1026,12,1,1,3
Shasta,12,2022-03-10,116,116,108,8,5012,5048,4697,351,21,3,3,3
Siskiyou,12,2022-03-10,20,20,19,1,390,392,374,18,1,3,3,1
Solano,12,2022-03-10,276,276,261,15,13106,13198,12486,712,39,2,2,9
Sonoma,12,2022-03-10,260,260,246,14,14410,14512,13727,785,16,0,0,7
Stanislaus,12,2022-03-10,246,246,225,21,10229,10302,9441,861,89,7,7,15
Sutter,12,2022-03-10,61,61,57,4,1885,1899,1784,115,0,1,1,0
Tehama,12,2022-03-10,31,31,28,3,1026,1032,935,97,0,2,2,1
Trinity,12,2022-03-10,3,3,3,0,110,110,101,9,0,0,0,0
Tulare,12,2022-03-10,242,242,221,21,9939,10011,9142,869,32,9,9,3
Tuolumne,12,2022-03-10,39,39,36,3,1267,1275,1188,87,3,0,0,1
Ventura,12,2022-03-10,374,374,361,13,25889,26073,25151,922,36,3,3,9
Yolo,12,2022-03-10,146,146,139,7,21754,21909,20933,976,4,0,0,1
Yuba,12,2022-03-10,42,42,40,2,1484,1496,1413,83,11,0,0,2
Alameda,13,2022-03-17,713,720,698,22,67826,68388,66315,2073,58,8,8,4
Amador,13,2022-03-17,25,25,24,1,1383,1394,1321,73,2,0,0,0
Butte,13,2022-03-17,84,84,82,2,3034,3059,2979,80,17,0,0,0
Calaveras,13,2022-03-17,12,12,11,1,734,739,705,34,0,0,0,0
Colusa,13,2022-03-17,1,1,1,0,250,251,240,11,2,0,0,0
Contra Costa,13,2022-03-17,501,506,482,24,28549,28784,27415,1369,23,6,6,9
Del Norte,13,2022-03-17,28,28,27,1,1190,1201,1151,50,0,1,1,2
El Dorado,13,2022-03-17,45,45,43,2,2915,2939,2801,138,1,2,2,2
Fresno,13,2022-03-17,399,402,381,21,20436,20604,19545,1059,117,11,11,15
Glenn,13,2022-03-17,10,10,10,0,320,321,307,14,1,0,0,0
Humboldt,13,2022-03-17,42,42,40,2,2408,2429,2327,102,3,1,1,2
Imperial,13,2022-03-17,66,66,63,3,4104,4138,3944,194,4,2,2,4
Inyo,13,2022-03-17,2,2,2,0,165,165,159,6,0,0,0,0
Kern,13,2022-03-17,232,232,222,10,19506,19668,18835,833,38,9,9,7
Kings,13,2022-03-17,117,117,111,6,4595,4633,4401,232,7,0,0,2
Lake,13,2022-03-17,29,29,27,2,1468,1481,1400,81,1,0,0,1
Lassen,13,2022-03-17,8,8,8,0,1534,1547,1490,57,0,0,0,0
Los Angeles,13,2022-03-17,3850,3882,3837,45,829572,836429,826762,9667,395,93,93,76
Madera,13,2022-03-17,48,48,46,2,3463,3492,3315,177,7,1,1,4
Marin,13,2022-03-17,152,152,145,7,6462,6516,6220,296,6,0,0,0
Mariposa,13,2022-03-17,7,7,7,0,248,249,236,13,0,0,0,0
Mendocino,13,2022-03-17,34,34,32,2,1363,1376,1278,98,3,2,2,3
Merced,13,2022-03-17,108,108,103,5,3993,4026,3849,177,19,4,4,5
Modoc,13,2022-03-17,3,3,3,0,51,51,49,2,0,0,0,0
Mono,13,2022-03-17,2,2,2,0,125,125,117,8,1,0,0,0
Monterey,13,2022-03-17,146,146,135,11,10122,10206,9419,787,20,2,2,0
Napa,13,2022-03-17,76,76,73,3,3743,3774,3618,156,6,2,2,3
Nevada,13,2022-03-17,30,30,28,2,1554,1566,1481,85,1,0,0,0
Orange,13,2022-03-17,783,790,758,32,98081,98889,94860,4029,104,20,20,25
Placer,13,2022-03-17,119,119,112,7,6865,6921,6523,398,33,0,0,4
Plumas,13,2022-03-17,4,4,4,0,257,258,243,15,0,0,0,0
Riverside,13,2022-03-17,726,733,694,39,54239,54687,51839,2848,79,11,11,15
Sacramento,13,2022-03-17,514,520,498,22,33246,33520,32127,1393,106,13,13,14
San Benito,13,2022-03-17,25,25,24,1,1412,1424,1376,48,0,0,0,1
San Bernardino,13,2022-03-17,510,515,499,16,51005,51424,49824,1600,69,8,8,34
San Diego,13,2022-03-17,1679,1693,1670,23,89668,90405,89200,1205,170,13,13,35
San Francisco,13,2022-03-17,610,616,578,38,33751,34028,31944,2084,35,6,6,7
San Joaquin,13,2022-03-17,257,257,245,12,16349,16483,15726,757,24,4,4,7
San Luis Obispo,13,2022-03-17,125,125,120,5,6731,6785,6542,243,4,4,4,1
San Mateo,13,2022-03-17,415,418,406,12,34872,35161,34198,963,28,0,0,1
Santa Barbara,13,2022-03-17,207,207,198,9,17136,17278,16561,717,16,2,2,4
Santa Clara,13,2022-03-17,1024,1033,1019,14,95360,96148,94843,1305,104,3,3,25
Santa Cruz,13,2022-03-17,232,232,224,8,21801,21981,21265,716,9,2,2,2
Shasta,13,2022-03-17,66,66,62,4,4471,4508,4270,238,15,8,8,1
Siskiyou,13,2022-03-17,10,10,10,0,376,379,366,13,1,1,1,0
Solano,13,2022-03-17,205,205,197,8,11755,11852,11369,483,27,1,1,3
Sonoma,13,2022-03-17,227,227,218,9,13116,13225,12688,537,6,3,3,2
Stanislaus,13,2022-03-17,180,180,168,12,8804,8878,8313,565,76,10,10,11
Sutter,13,2022-03-17,25,25,24,1,1510,1524,1454,70,0,1,1,0
Tehama,13,2022-03-17,11,11,10,1,968,974,904,70,2,2,2,0
Trinity,13,2022-03-17,1,1,1,0,93,93,87,6,0,0,0,0
Tulare,13,2022-03-17,140,140,131,9,8541,8612,8042,570,29,1,1,5
Tuolumne,13,2022-03-17,19,19,18,1,1225,1234,1170,64,2,0,0,0
Ventura,13,2022-03-17,298,298,290,8,23856,24053,23415,638,35,8,8,3
Yolo,13,2022-03-17,99,99,96,3,22261,22446,21696,750,2,2,2,1
Yuba,13,2022-03-17,43,43,41,2,1312,1323,1268,55,6,0,0,3
Alameda,14,2022-03-24,847,855,835,20,60125,60708,59322,1386,52,3,3,3
Amador,14,2022-03-24,17,17,16,1,1363,1377,1322,55,2,0,0,0
Butte,14,2022-03-24,74,74,73,1,2819,2847,2791,56,16,0,0,2
Calaveras,14,2022-03-24,13,13,13,0,598,603,582,21,0,0,0,0
Colusa,14,2022-03-24,4,4,4,0,208,208,201,7,0,0,0,0
Contra Costa,14,2022-03-24,475,480,463,17,25103,25346,24439,907,30,4,4,4
Del Norte,14,2022-03-24,18,18,17,1,1183,1195,1157,38,0,0,0,0
El Dorado,14,2022-03-24,48,48,46,2,2742,2768,2670,98,1,1,1,0
Fresno,14,2022-03-24,315,316,304,12,18792,18973,18238,735,98,8,8,12
Glenn,14,2022-03-24,6,6,6,0,335,337,326,11,0,0,0,0
Humboldt,14,2022-03-24,29,29,28,1,2622,2647,2563,84,4,1,1,2
Imperial,14,2022-03-24,55,55,53,2,3764,3800,3665,135,4,2,2,3
Inyo,14,2022-03-24,1,1,1,0,166,166,162,4,0,0,0,0
Kern,14,2022-03-24,174,174,168,6,18806,18987,18382,605,27,5,5,7
Kings,14,2022-03-24,64,64,62,2,4332,4374,4209,165,3,3,3,1
Lake,14,2022-03-24,17,17,16,1,1199,1212,1162,50,0,0,0,0
Lassen,14,2022-03-24,7,7,7,0,1409,1423,1383,40,0,0,0,0
Los Angeles,14,2022-03-24,4369,4411,4372,39,791712,799401,792500,6901,291,57,57,59
Madera,14,2022-03-24,29,29,28,1,3318,3351,3223,128,4,0,0,1
Marin,14,2022-03-24,154,154,149,5,5785,5842,5642,200,5,1,1,0
Mariposa,14,2022-03-24,7,7,7,0,174,174,167,7,0,0,0,0
Mendocino,14,2022-03-24,32,32,30,2,1419,1433,1355,78,2,0,0,1
Merced,14,2022-03-24,67,67,65,2,3432,3465,3350,115,10,2,2,2
Modoc,14,2022-03-24,2,2,2,0,51,51,49,2,0,0,0,0
Mono,14,2022-03-24,3,3,3,0,132,132,125,7,0,0,0,0
Monterey,14,2022-03-24,167,167,157,10,9601,9693,9124,569,21,0,0,1
Napa,14,2022-03-24,54,54,52,2,3303,3335,3232,103,2,0,0,2
Nevada,14,2022-03-24,26,26,25,1,1519,1534,1471,63,0,0,0,0
Orange,14,2022-03-24,785,793,769,24,92372,93267,90406,2861,105,13,13,24
Placer,14,2022-03-24,111,111,106,5,6282,6344,6069,275,33,3,3,8
Plumas,14,2022-03-24,2,2,2,0,271,273,261,12,0,0,0,0
Riverside,14,2022-03-24,516,522,501,21,45358,45797,43986,1811,63,8,8,12
Sacramento,14,2022-03-24,452,457,443,14,32282,32595,31577,1018,83,6,6,14
San Benito,14,2022-03-24,12,12,12,0,1322,1337,1303,34,0,1,1,0
San Bernardino,14,2022-03-24,478,483,472,11,43287,43705,42677,1028,57,7,7,25
San Diego,14,2022-03-24,1277,1289,1276,13,76534,77271,76499,772,123,10,10,39
San Francisco,14,2022-03-24,769,777,741,36,32630,32945,31418,1527,27,2,2,4
San Joaquin,14,2022-03-24,187,187,181,6,16524,16685,16115,570,22,7,7,7
San Luis Obispo,14,2022-03-24,100,100,97,3,5825,5882,5723,159,4,4,4,1
San Mateo,14,2022-03-24,490,495,485,10,34048,34379,33674,705,22,2,2,4
Santa Barbara,14,2022-03-24,115,115,111,4,9380,9470,9171,299,17,5,5,2
Santa Clara,14,2022-03-24,1147,1159,1147,12,90410,91288,90362,926,99,7,7,19
Santa Cruz,14,2022-03-24,139,139,136,3,18143,18319,17872,447,6,0,0,2
Shasta,14,2022-03-24,35,35,34,1,3857,3894,3739,155,6,5,5,2
Siskiyou,14,2022-03-24,4,4,4,0,306,307,299,8,1,0,0,0
Solano,14,2022-03-24,164,164,159,5,11067,11173,10830,343,22,1,1,7
Sonoma,14,2022-03-24,210,210,203,7,8736,8820,8545,275,8,0,0,3
Stanislaus,14,2022-03-24,130,130,124,6,8198,8277,7879,398,43,8,8,7
Sutter,14,2022-03-24,31,31,30,1,1498,1513,1461,52,0,1,1,0
Tehama,14,2022-03-24,11,11,10,1,842,850,804,46,0,0,0,1
Trinity,14,2022-03-24,0,0,0,0,104,104,99,5,0,0,0,0
Tulare,14,2022-03-24,101,101,96,5,7979,8057,7653,404,20,5,5,4
Tuolumne,14,2022-03-24,10,10,10,0,1069,1079,1037,42,1,0,0,1
Ventura,14,2022-03-24,318,321,315,6,21886,22099,21659,440,19,4,4,3
Yolo,14,2022-03-24,101,101,98,3,18057,18231,17768,463,1,1,1,0
Yuba,14,2022-03-24,28,28,27,1,1295,1307,1266,41,4,1,1,1
Alameda,15,2022-03-31,852,862,847,15,58144,58790,57786,1004,42,5,5,2
Amador,15,2022-03-31,5,5,5,0,1229,1243,1206,37,2,0,0,0
Butte,15,2022-03-31,56,56,55,1,2469,2496,2459,37,11,0,0,1
Calaveras,15,2022-03-31,11,11,11,0,582,588,573,15,0,0,0,0
Colusa,15,2022-03-31,2,2,2,0,198,200,195,5,0,0,0,0
Contra Costa,15,2022-03-31,527,534,519,15,24607,24881,24213,668,18,0,0,4
Del Norte,15,2022-03-31,11,11,11,0,1096,1108,1082,26,1,0,0,0
El Dorado,15,2022-03-31,56,56,54,2,2764,2796,2721,75,0,1,1,0
Fresno,15,2022-03-31,207,208,202,6,17092,17281,16776,505,75,7,7,10
Glenn,15,2022-03-31,4,4,4,0,257,258,252,6,0,0,0,0
Humboldt,15,2022-03-31,20,20,20,0,2508,2535,2475,60,4,0,0,3
Imperial,15,2022-03-31,62,62,60,2,3512,3552,3457,95,3,0,0,3
Inyo,15,2022-03-31,7,7,7,0,180,181,177,4,0,0,0,0
Kern,15,2022-03-31,158,158,154,4,17345,17536,17116,420,18,2,2,8
Kings,15,2022-03-31,47,47,46,1,4136,4181,4062,119,4,0,0,0
Lake,15,2022-03-31,10,10,10,0,995,1006,975,31,0,0,0,0
Lassen,15,2022-03-31,3,3,3,0,1197,1210,1185,25,0,0,0,0
Los Angeles,15,2022-03-31,4764,4816,4785,31,731203,739337,734597,4740,240,52,52,47
Madera,15,2022-03-31,28,28,27,1,3275,3311,3215,96,2,0,0,1
Marin,15,2022-03-31,150,150,146,4,6388,6459,6293,166,2,0,0,0
Mariposa,15,2022-03-31,1,1,1,0,182,182,177,5,0,1,1,0
Mendocino,15,2022-03-31,24,24,23,1,1322,1336,1281,55,0,1,1,0
Merced,15,2022-03-31,58,58,57,1,3295,3331,3248,83,6,2,2,0
Modoc,15,2022-03-31,4,4,4,0,41,41,40,1,0,0,0,0
Mono,15,2022-03-31,2,2,2,0,146,146,141,5,0,0,0,0
Monterey,15,2022-03-31,129,129,123,6,7691,7775,7429,346,14,3,3,0
Napa,15,2022-03-31,58,58,57,1,3223,3259,3183,76,2,2,2,1
Nevada,15,2022-03-31,26,26,25,1,1367,1383,1340,43,2,2,2,0
Orange,15,2022-03-31,821,830,811,19,88610,89594,87535,2059,82,11,11,14
Placer,15,2022-03-31,111,111,107,4,6252,6322,6117,205,29,3,3,4
Plumas,15,2022-03-31,5,5,5,0,230,231,223,8,0,0,0,0
Riverside,15,2022-03-31,572,579,562,17,40495,40943,39721,1222,43,8,8,9
Sacramento,15,2022-03-31,430,435,425,10,32094,32450,31691,759,61,6,6,13
San Benito,15,2022-03-31,12,12,12,0,1248,1262,1238,24,0,0,0,0
San Bernardino,15,2022-03-31,552,558,548,10,41023,41477,40750,727,37,8,8,14
San Diego,15,2022-03-31,1446,1462,1451,11,66381,67115,66614,501,99,5,5,31
San Francisco,15,2022-03-31,853,863,833,30,30036,30368,29301,1067,23,4,4,2
San Joaquin,15,2022-03-31,196,196,191,5,16092,16271,15850,421,12,4,4,7
San Luis Obispo,15,2022-03-31,99,99,97,2,5605,5666,5550,116,6,0,0,1
San Mateo,15,2022-03-31,576,583,574,9,30325,30661,30187,474,12,2,2,7
Santa Barbara,15,2022-03-31,157,157,153,4,14097,14255,13924,331,13,1,1,2
Santa Clara,15,2022-03-31,1319,1335,1325,10,91314,92327,91625,702,90,8,8,17
Santa Cruz,15,2022-03-31,179,180,177,3,20427,20654,20275,379,3,1,1,2
Shasta,15,2022-03-31,28,28,27,1,3607,3648,3539,109,2,1,1,5
Siskiyou,15,2022-03-31,7,7,7,0,299,303,297,6,0,0,0,0
Solano,15,2022-03-31,140,140,137,3,10352,10466,10225,241,13,1,1,5
Sonoma,15,2022-03-31,271,272,266,6,10224,10338,10100,238,14,0,0,0
Stanislaus,15,2022-03-31,94,94,91,3,7863,7950,7661,289,23,1,1,3
Sutter,15,2022-03-31,30,30,29,1,1321,1335,1300,35,0,0,0,0
Tehama,15,2022-03-31,8,8,8,0,758,766,735,31,1,2,2,0
Trinity,15,2022-03-31,1,1,1,0,84,84,81,3,0,0,0,0
Tulare,15,2022-03-31,55,55,53,2,7646,7731,7438,293,13,4,4,0
Tuolumne,15,2022-03-31,12,12,12,0,996,1008,978,30,0,0,0,0
Ventura,15,2022-03-31,305,307,302,5,21023,21255,20939,316,22,6,6,2
Yolo,15,2022-03-31,62,62,61,1,25890,26177,25689,488,2,1,1,0
Yuba,15,2022-03-31,21,21,20,1,1062,1074,1049,25,4,0,0,2
Alameda,16,2022-04-07,1313,1328,1311,17,49173,49788,49148,640,43,6,6,4
Amador,16,2022-04-07,4,4,4,0,1094,1108,1083,25,1,0,0,0
Butte,16,2022-04-07,35,35,35,0,2164,2192,2168,24,5,2,2,1
Calaveras,16,2022-04-07,11,11,11,0,646,654,642,12,0,0,0,0
Colusa,16,2022-04-07,5,5,5,0,195,197,193,4,0,0,0,0
Contra Costa,16,2022-04-07,575,582,570,12,19744,19991,19585,406,18,2,2,4
Del Norte,16,2022-04-07,7,7,7,0,1012,1025,1007,18,0,0,0,1
El Dorado,16,2022-04-07,48,48,47,1,2607,2641,2588,53,0,0,0,1
Fresno,16,2022-04-07,210,210,205,5,16896,17108,16734,374,53,1,1,12
Glenn,16,2022-04-07,3,3,3,0,244,246,242,4,0,0,0,0
Humboldt,16,2022-04-07,33,33,32,1,2295,2324,2283,41,8,1,1,2
Imperial,16,2022-04-07,24,24,24,0,3450,3494,3424,70,2,0,0,2
Inyo,16,2022-04-07,7,7,7,0,190,191,188,3,0,0,0,0
Kern,16,2022-04-07,133,133,131,2,17113,17328,17019,309,19,2,2,5
Kings,16,2022-04-07,32,32,31,1,4287,4342,4250,92,3,0,0,1
Lake,16,2022-04-07,18,18,18,0,845,856,836,20,0,0,0,0
Lassen,16,2022-04-07,4,4,4,0,1325,1342,1321,21,0,0,0,0
Los Angeles,16,2022-04-07,6123,6201,6171,30,754744,764216,760548,3668,236,49,49,39
Madera,16,2022-04-07,25,25,24,1,3159,3198,3129,69,3,0,0,1
Marin,16,2022-04-07,194,195,191,4,5653,5723,5612,111,6,0,0,0
Mariposa,16,2022-04-07,8,8,8,0,264,268,262,6,0,0,0,0
Mendocino,16,2022-04-07,31,31,30,1,1118,1132,1097,35,0,0,0,0
Merced,16,2022-04-07,61,61,60,1,3291,3333,3271,62,5,1,1,1
Modoc,16,2022-04-07,1,1,1,0,50,50,49,1,0,0,0,0
Mono,16,2022-04-07,2,2,2,0,123,123,120,3,0,0,0,0
Monterey,16,2022-04-07,120,120,116,4,7215,7306,7061,245,12,2,2,0
Napa,16,2022-04-07,97,97,95,2,3104,3143,3088,55,1,0,0,1
Nevada,16,2022-04-07,31,31,30,1,1500,1520,1485,35,1,0,0,0
Orange,16,2022-04-07,1080,1093,1074,19,60854,61610,60532,1078,64,10,10,20
Placer,16,2022-04-07,116,116,113,3,6428,6508,6348,160,19,2,2,4
Plumas,16,2022-04-07,2,2,2,0,248,251,245,6,0,0,0,0
Riverside,16,2022-04-07,713,722,706,16,38520,39001,38132,869,37,5,5,5
Sacramento,16,2022-04-07,487,492,483,9,31669,32064,31500,564,55,8,8,9
San Benito,16,2022-04-07,19,19,19,0,1199,1215,1198,17,0,0,0,0
San Bernardino,16,2022-04-07,754,765,755,10,41625,42145,41592,553,44,3,3,7
San Diego,16,2022-04-07,1781,1804,1794,10,72074,72976,72573,403,88,5,5,27
San Francisco,16,2022-04-07,1163,1178,1147,31,29309,29675,28899,776,19,6,6,4
San Joaquin,16,2022-04-07,230,232,227,5,15711,15908,15600,308,8,0,0,6
San Luis Obispo,16,2022-04-07,106,106,104,2,5413,5481,5398,83,1,1,1,1
San Mateo,16,2022-04-07,779,789,780,9,30308,30689,30336,353,10,2,2,1
Santa Barbara,16,2022-04-07,233,236,232,4,15178,15369,15099,270,6,1,1,1
Santa Clara,16,2022-04-07,1581,1601,1592,9,81607,82629,82160,469,74,0,0,16
Santa Cruz,16,2022-04-07,273,277,273,4,10545,10676,10526,150,0,1,1,0
Shasta,16,2022-04-07,22,22,21,1,3311,3352,3277,75,1,1,1,3
Siskiyou,16,2022-04-07,3,3,3,0,317,321,316,5,0,0,0,0
Solano,16,2022-04-07,220,222,218,4,9463,9580,9415,165,18,0,0,5
Sonoma,16,2022-04-07,396,403,396,7,10833,10969,10779,190,4,0,0,0
Stanislaus,16,2022-04-07,120,120,117,3,7901,8000,7782,218,16,1,1,3
Sutter,16,2022-04-07,23,23,23,0,1352,1369,1342,27,0,1,1,0
Tehama,16,2022-04-07,7,7,7,0,756,765,742,23,0,0,0,0
Trinity,16,2022-04-07,0,0,0,0,71,71,69,2,0,0,0,0
Tulare,16,2022-04-07,50,50,49,1,8096,8198,7966,232,9,4,4,1
Tuolumne,16,2022-04-07,15,15,15,0,1058,1070,1046,24,0,1,1,0
Ventura,16,2022-04-07,313,317,313,4,18555,18788,18578,210,17,2,2,2
Yolo,16,2022-04-07,96,96,95,1,20304,20556,20261,295,0,0,0,0
Yuba,16,2022-04-07,12,12,12,0,1061,1075,1056,19,2,0,0,0
Alameda,17,2022-04-14,1669,1693,1677,16,54773,55555,55026,529,49,2,2,4
Amador,17,2022-04-14,9,9,9,0,1149,1165,1146,19,1,0,0,0
Butte,17,2022-04-14,49,49,49,0,2055,2085,2068,17,4,0,0,1
Calaveras,17,2022-04-14,16,16,16,0,627,637,628,9,0,0,0,0
Colusa,17,2022-04-14,5,5,5,0,177,178,175,3,0,0,0,0
Contra Costa,17,2022-04-14,927,940,926,14,24465,24812,24439,373,24,0,0,2
Del Norte,17,2022-04-14,13,13,13,0,1017,1031,1018,13,0,0,0,0
El Dorado,17,2022-04-14,56,56,55,1,2438,2472,2435,37,0,0,0,0
Fresno,17,2022-04-14,189,190,187,3,14238,14440,14202,238,41,3,3,4
Glenn,17,2022-04-14,4,4,4,0,236,238,235,3,0,0,0,0
Humboldt,17,2022-04-14,64,64,63,1,2054,2083,2055,28,6,0,0,2
Imperial,17,2022-04-14,35,35,34,1,3390,3439,3388,51,2,0,0,1
Inyo,17,2022-04-14,1,1,1,0,159,160,158,2,0,0,0,0
Kern,17,2022-04-14,137,137,135,2,14188,14390,14197,193,11,1,1,8
Kings,17,2022-04-14,39,39,38,1,3623,3675,3616,59,3,0,0,0
Lake,17,2022-04-14,17,17,17,0,847,861,846,15,0,0,0,1
Lassen,17,2022-04-14,2,2,2,0,1284,1301,1286,15,0,0,0,0
Los Angeles,17,2022-04-14,7245,7347,7321,26,447081,453388,451722,1666,197,34,34,31
Madera,17,2022-04-14,27,27,27,0,2718,2756,2711,45,2,0,0,2
Marin,17,2022-04-14,250,254,250,4,6122,6208,6119,89,3,0,0,1
Mariposa,17,2022-04-14,12,12,12,0,258,263,259,4,0,0,0,0
Mendocino,17,2022-04-14,37,37,36,1,1178,1196,1169,27,0,0,0,1
Merced,17,2022-04-14,80,80,79,1,3169,3214,3169,45,7,1,1,1
Modoc,17,2022-04-14,0,0,0,0,41,41,40,1,0,0,0,0
Mono,17,2022-04-14,10,10,10,0,187,189,185,4,0,0,0,0
Monterey,17,2022-04-14,110,110,107,3,6506,6598,6431,167,9,1,1,0
Napa,17,2022-04-14,130,130,128,2,2606,2643,2608,35,2,0,0,0
Nevada,17,2022-04-14,43,43,42,1,1280,1298,1275,23,0,0,0,2
Orange,17,2022-04-14,1308,1328,1311,17,77281,78388,77390,998,54,6,6,13
Placer,17,2022-04-14,159,159,156,3,4978,5048,4955,93,25,1,1,5
Plumas,17,2022-04-14,10,10,10,0,223,227,223,4,0,0,0,0
Riverside,17,2022-04-14,817,828,814,14,37499,38034,37402,632,46,4,4,8
Sacramento,17,2022-04-14,571,579,571,8,27921,28317,27944,373,50,8,8,6
San Benito,17,2022-04-14,17,17,17,0,1174,1192,1179,13,0,0,0,0
San Bernardino,17,2022-04-14,980,994,984,10,41057,41640,41232,408,34,2,2,8
San Diego,17,2022-04-14,1843,1870,1862,8,70649,71651,71354,297,84,5,5,21
San Francisco,17,2022-04-14,1223,1240,1216,24,30327,30760,30155,605,29,2,2,1
San Joaquin,17,2022-04-14,223,227,224,3,14911,15123,14904,219,5,0,0,4
San Luis Obispo,17,2022-04-14,137,137,135,2,4804,4872,4817,55,2,1,1,0
San Mateo,17,2022-04-14,985,998,989,9,29619,30041,29783,258,11,3,3,3
Santa Barbara,17,2022-04-14,314,319,315,4,14917,15130,14931,199,4,1,1,0
Santa Clara,17,2022-04-14,1859,1885,1877,8,76205,77289,76962,327,70,6,6,13
Santa Cruz,17,2022-04-14,389,393,389,4,12910,13094,12960,134,2,0,0,1
Shasta,17,2022-04-14,20,20,20,0,2845,2885,2837,48,2,0,0,2
Siskiyou,17,2022-04-14,2,2,2,0,333,336,332,4,0,0,0,1
Solano,17,2022-04-14,214,217,214,3,9273,9404,9282,122,11,1,1,1
Sonoma,17,2022-04-14,432,439,433,6,11084,11243,11098,145,13,1,1,2
Stanislaus,17,2022-04-14,143,143,140,3,7853,7964,7802,162,16,1,1,4
Sutter,17,2022-04-14,18,18,18,0,1189,1206,1188,18,0,0,0,0
Tehama,17,2022-04-14,9,9,9,0,681,690,674,16,0,0,0,0
Trinity,17,2022-04-14,0,0,0,0,80,80,78,2,0,0,0,0
Tulare,17,2022-04-14,62,62,61,1,6879,6977,6828,149,13,2,2,0
Tuolumne,17,2022-04-14,24,24,24,0,1061,1077,1059,18,0,0,0,0
Ventura,17,2022-04-14,334,338,335,3,16790,17029,16887,142,10,1,1,1
Yolo,17,2022-04-14,112,112,111,1,18964,19234,19030,204,2,0,0,0
Yuba,17,2022-04-14,18,18,18,0,1014,1028,1014,14,1,0,0,0
Alameda,18,2022-04-21,2108,2141,2126,15,53831,54718,54330,388,42,3,3,4
Amador,18,2022-04-21,15,15,15,0,1241,1262,1246,16,1,0,0,0
Butte,18,2022-04-21,31,31,31,0,2172,2207,2194,13,6,1,1,1
Calaveras,18,2022-04-21,21,21,21,0,611,621,614,7,0,1,1,0
Colusa,18,2022-04-21,2,2,2,0,161,164,162,2,0,0,0,0
Contra Costa,18,2022-04-21,1310,1331,1316,15,24849,25259,24975,284,25,2,2,3
Del Norte,18,2022-04-21,18,18,18,0,1042,1059,1049,10,0,0,0,0
El Dorado,18,2022-04-21,87,87,86,1,2566,2608,2579,29,1,0,0,0
Fresno,18,2022-04-21,310,314,310,4,15445,15699,15508,191,41,4,4,4
Glenn,18,2022-04-21,4,4,4,0,244,248,246,2,0,0,0,0
Humboldt,18,2022-04-21,155,158,156,2,2582,2624,2598,26,5,1,1,2
Imperial,18,2022-04-21,51,51,50,1,3290,3343,3306,37,3,0,0,1
Inyo,18,2022-04-21,6,6,6,0,186,189,187,2,1,0,0,0
Kern,18,2022-04-21,196,200,198,2,16281,16550,16387,163,9,2,2,7
Kings,18,2022-04-21,54,54,53,1,4363,4435,4383,52,1,1,1,0
Lake,18,2022-04-21,17,17,17,0,773,786,776,10,3,0,0,0
Lassen,18,2022-04-21,0,0,0,0,1473,1498,1485,13,0,0,0,0
Los Angeles,18,2022-04-21,9807,9969,9942,27,757789,770414,768406,2008,193,27,27,26
Madera,18,2022-04-21,25,25,25,0,2805,2850,2816,34,4,0,0,1
Marin,18,2022-04-21,332,339,335,4,5931,6029,5964,65,6,0,0,1
Mariposa,18,2022-04-21,15,15,15,0,232,237,234,3,0,0,0,0
Mendocino,18,2022-04-21,62,62,61,1,1310,1331,1308,23,3,1,1,0
Merced,18,2022-04-21,72,72,71,1,2908,2956,2925,31,5,2,2,0
Modoc,18,2022-04-21,2,2,2,0,31,32,31,1,0,0,0,0
Mono,18,2022-04-21,7,7,7,0,105,105,103,2,0,0,0,0
Monterey,18,2022-04-21,241,244,239,5,7177,7294,7158,136,5,1,1,0
Napa,18,2022-04-21,195,198,196,2,3277,3329,3297,32,0,0,0,0
Nevada,18,2022-04-21,52,52,51,1,1337,1359,1341,18,4,0,0,0
Orange,18,2022-04-21,1682,1711,1695,16,81506,82851,82059,792,50,6,6,14
Placer,18,2022-04-21,177,180,178,2,5436,5526,5451,75,19,0,0,3
Plumas,18,2022-04-21,2,2,2,0,233,238,235,3,0,0,0,0
Riverside,18,2022-04-21,1100,1119,1105,14,38174,38804,38324,480,49,4,4,6
Sacramento,18,2022-04-21,906,921,912,9,30111,30607,30308,299,52,8,8,7
San Benito,18,2022-04-21,30,30,30,0,1154,1173,1164,9,0,0,0,0
San Bernardino,18,2022-04-21,1229,1251,1242,9,40640,41311,41012,299,27,5,5,10
San Diego,18,2022-04-21,2452,2493,2485,8,70116,71269,71051,218,76,5,5,13
San Francisco,18,2022-04-21,1785,1813,1786,27,30978,31487,31024,463,29,1,1,4
San Joaquin,18,2022-04-21,321,326,322,4,15204,15455,15288,167,9,1,1,3
San Luis Obispo,18,2022-04-21,188,190,188,2,4918,4998,4956,42,3,1,1,0
San Mateo,18,2022-04-21,1318,1340,1331,9,31094,31606,31404,202,10,1,1,4
Santa Barbara,18,2022-04-21,326,332,329,3,14583,14824,14679,145,8,0,0,0
Santa Clara,18,2022-04-21,2606,2649,2641,8,67012,68114,67900,214,70,2,2,11
Santa Cruz,18,2022-04-21,434,440,437,3,16570,16846,16721,125,2,1,1,1
Shasta,18,2022-04-21,47,47,46,1,3045,3096,3057,39,4,1,1,1
Siskiyou,18,2022-04-21,10,10,10,0,321,325,322,3,0,0,0,0
Solano,18,2022-04-21,355,360,357,3,9867,10029,9933,96,8,0,0,1
Sonoma,18,2022-04-21,595,605,599,6,11395,11583,11471,112,16,1,1,1
Stanislaus,18,2022-04-21,181,184,181,3,7487,7610,7494,116,20,0,0,2
Sutter,18,2022-04-21,23,23,23,0,1261,1281,1267,14,0,0,0,0
Tehama,18,2022-04-21,11,11,11,0,622,632,621,11,1,0,0,0
Trinity,18,2022-04-21,2,2,2,0,79,79,78,1,0,0,0,0
Tulare,18,2022-04-21,84,84,83,1,6825,6938,6828,110,11,0,0,0
Tuolumne,18,2022-04-21,28,28,28,0,1100,1118,1104,14,0,1,1,0
Ventura,18,2022-04-21,474,482,479,3,17351,17636,17528,108,11,4,4,1
Yolo,18,2022-04-21,165,168,167,1,18282,18582,18436,146,0,1,1,0
Yuba,18,2022-04-21,36,36,36,0,1087,1106,1095,11,1,0,0,0
Alameda,19,2022-04-28,2911,2967,2951,16,68204,69543,69175,368,39,5,5,3
Amador,19,2022-04-28,26,26,26,0,1326,1351,1338,13,0,0,0,0
Butte,19,2022-04-28,88,88,88,0,2284,2329,2318,11,5,1,1,0
Calaveras,19,2022-04-28,30,30,30,0,725,739,733,6,0,0,0,0
Colusa,19,2022-04-28,3,3,3,0,234,238,236,2,0,0,0,0
Contra Costa,19,2022-04-28,1569,1600,1587,13,28406,28961,28717,244,30,3,3,3
Del Norte,19,2022-04-28,30,30,30,0,1172,1196,1187,9,1,0,0,0
El Dorado,19,2022-04-28,110,110,109,1,2685,2737,2714,23,0,0,0,1
Fresno,19,2022-04-28,419,429,425,4,16771,17098,16942,156,35,2,2,6
Glenn,19,2022-04-28,2,2,2,0,245,249,247,2,0,0,0,0
Humboldt,19,2022-04-28,184,188,187,1,2850,2905,2883,22,4,0,0,2
Imperial,19,2022-04-28,97,97,96,1,3674,3746,3715,31,2,0,0,1
Inyo,19,2022-04-28,5,5,5,0,203,207,206,1,0,0,0,0
Kern,19,2022-04-28,265,270,268,2,17817,18165,18030,135,16,1,1,4
Kings,19,2022-04-28,46,46,46,0,4660,4753,4711,42,5,0,0,0
Lake,19,2022-04-28,27,27,27,0,990,1010,1000,10,1,0,0,0
Lassen,19,2022-04-28,8,8,8,0,1562,1593,1583,10,0,0,0,0
Los Angeles,19,2022-04-28,13031,13286,13260,26,916820,934861,933011,1850,228,23,23,25
Madera,19,2022-04-28,60,60,59,1,3081,3141,3113,28,2,0,0,1
Marin,19,2022-04-28,352,359,356,3,6356,6480,6428,52,9,0,0,0
Mariposa,19,2022-04-28,7,7,7,0,216,220,218,2,0,0,0,0
Mendocino,19,2022-04-28,46,46,45,1,1212,1236,1220,16,0,1,1,0
Merced,19,2022-04-28,109,109,108,1,3223,3287,3261,26,6,0,0,0
Modoc,19,2022-04-28,0,0,0,0,43,44,43,1,0,0,0,0
Mono,19,2022-04-28,3,3,3,0,81,81,80,1,0,0,0,0
Monterey,19,2022-04-28,317,323,318,5,8258,8419,8301,118,8,2,2,0
Napa,19,2022-04-28,205,210,208,2,3518,3588,3562,26,4,0,0,0
Nevada,19,2022-04-28,58,58,57,1,1509,1538,1523,15,2,0,0,0
Orange,19,2022-04-28,2267,2311,2294,17,87632,89350,88710,640,65,6,6,11
Placer,19,2022-04-28,248,254,251,3,6148,6268,6204,64,22,0,0,4
Plumas,19,2022-04-28,5,5,5,0,251,256,253,3,0,0,0,0
Riverside,19,2022-04-28,1546,1577,1562,15,41357,42168,41778,390,37,3,3,7
Sacramento,19,2022-04-28,1132,1155,1147,8,31971,32597,32358,239,48,2,2,8
San Benito,19,2022-04-28,41,41,41,0,1156,1178,1171,7,0,0,0,0
San Bernardino,19,2022-04-28,1277,1300,1293,7,42582,43416,43180,236,24,5,5,6
San Diego,19,2022-04-28,3493,3562,3554,8,72313,73722,73553,169,82,2,2,13
San Francisco,19,2022-04-28,2150,2192,2168,24,34237,34907,34525,382,41,0,0,3
San Joaquin,19,2022-04-28,434,444,440,4,14882,15174,15052,122,11,1,1,3
San Luis Obispo,19,2022-04-28,237,241,239,2,5118,5217,5184,33,4,0,0,0
San Mateo,19,2022-04-28,1606,1638,1630,8,35751,36453,36279,174,13,0,0,4
Santa Barbara,19,2022-04-28,398,405,402,3,15561,15868,15752,116,9,2,2,2
Santa Clara,19,2022-04-28,3624,3694,3685,9,91878,93687,93469,218,66,4,4,10
Santa Cruz,19,2022-04-28,564,576,573,3,21726,22153,22028,125,2,0,0,0
Shasta,19,2022-04-28,63,63,62,1,3430,3498,3465,33,2,0,0,2
Siskiyou,19,2022-04-28,7,7,7,0,313,318,316,2,0,0,0,0
Solano,19,2022-04-28,549,560,556,4,11162,11382,11301,81,9,0,0,2
Sonoma,19,2022-04-28,711,724,719,5,12415,12658,12567,91,15,0,0,4
Stanislaus,19,2022-04-28,274,280,277,3,8111,8269,8175,94,21,2,2,0
Sutter,19,2022-04-28,48,48,48,0,1297,1323,1312,11,0,1,1,0
Tehama,19,2022-04-28,19,19,19,0,696,710,701,9,0,0,0,0
Trinity,19,2022-04-28,1,1,1,0,66,66,65,1,0,0,0,0
Tulare,19,2022-04-28,122,124,123,1,7201,7341,7254,87,9,1,1,0
Tuolumne,19,2022-04-28,75,75,74,1,1192,1216,1205,11,3,0,0,0
Ventura,19,2022-04-28,653,665,662,3,19771,20158,20065,93,12,2,2,3
Yolo,19,2022-04-28,223,227,226,1,19262,19638,19523,115,2,0,0,1
Yuba,19,2022-04-28,26,26,26,0,1008,1028,1020,8,1,0,0,1
Alameda,20,2022-05-05,3730,3823,3808,15,68548,70259,69982,277,52,3,3,7
Amador,20,2022-05-05,20,20,20,0,1422,1457,1447,10,0,0,0,0
Butte,20,2022-05-05,103,105,105,0,2315,2372,2364,8,2,0,0,0
Calaveras,20,2022-05-05,27,27,27,0,674,691,687,4,1,0,0,0
Colusa,20,2022-05-05,5,5,5,0,202,206,205,1,0,0,0,0
Contra Costa,20,2022-05-05,2169,2223,2209,14,29602,30336,30146,190,33,3,3,7
Del Norte,20,2022-05-05,40,40,40,0,1215,1245,1238,7,0,0,0,0
El Dorado,20,2022-05-05,154,158,157,1,2821,2890,2872,18,2,0,0,0
Fresno,20,2022-05-05,589,604,600,4,17581,18017,17895,122,29,4,4,2
Glenn,20,2022-05-05,9,9,9,0,240,246,245,1,0,0,0,0
Humboldt,20,2022-05-05,290,298,296,2,3225,3305,3287,18,3,0,0,2
Imperial,20,2022-05-05,120,123,122,1,3672,3763,3740,23,0,0,0,1
Inyo,20,2022-05-05,4,4,4,0,190,194,193,1,0,0,0,0
Kern,20,2022-05-05,384,394,392,2,18069,18519,18417,102,18,1,1,3
Kings,20,2022-05-05,83,84,83,1,4911,5034,5001,33,3,0,0,0
Lake,20,2022-05-05,29,29,29,0,1024,1048,1040,8,1,0,0,1
Lassen,20,2022-05-05,3,3,3,0,1698,1740,1732,8,0,0,0,0
Los Angeles,20,2022-05-05,16278,16680,16655,25,902833,925397,924033,1364,212,18,18,36
Madera,20,2022-05-05,116,118,117,1,3791,3884,3858,26,2,0,0,0
Marin,20,2022-05-05,560,573,570,3,7169,7346,7302,44,12,0,0,0
Mariposa,20,2022-05-05,24,24,24,0,264,271,269,2,0,0,0,0
Mendocino,20,2022-05-05,79,79,78,1,1269,1301,1288,13,0,0,0,1
Merced,20,2022-05-05,154,158,157,1,3333,3416,3396,20,3,3,3,0
Modoc,20,2022-05-05,2,2,2,0,37,38,37,1,0,0,0,0
Mono,20,2022-05-05,11,11,11,0,117,119,118,1,0,0,0,0
Monterey,20,2022-05-05,411,422,418,4,9052,9276,9179,97,10,0,0,0
Napa,20,2022-05-05,235,242,241,1,3296,3378,3360,18,1,0,0,0
Nevada,20,2022-05-05,92,92,91,1,1572,1610,1598,12,2,0,0,0
Orange,20,2022-05-05,3109,3187,3170,17,89302,91525,91037,488,81,4,4,17
Placer,20,2022-05-05,415,425,422,3,6628,6793,6741,52,19,0,0,4
Plumas,20,2022-05-05,12,12,12,0,258,264,262,2,0,0,0,0
Riverside,20,2022-05-05,2287,2343,2327,16,43947,45039,44728,311,28,4,4,8
Sacramento,20,2022-05-05,1710,1753,1743,10,35454,36334,36136,198,56,3,3,11
San Benito,20,2022-05-05,61,61,61,0,1413,1449,1443,6,0,0,0,0
San Bernardino,20,2022-05-05,1640,1681,1674,7,44257,45356,45173,183,43,0,0,5
San Diego,20,2022-05-05,4615,4730,4722,8,83179,85250,85106,144,89,3,3,13
San Francisco,20,2022-05-05,2606,2669,2647,22,36712,37624,37316,308,45,5,5,10
San Joaquin,20,2022-05-05,618,633,629,4,15331,15711,15617,94,6,0,0,2
San Luis Obispo,20,2022-05-05,268,274,273,1,5204,5334,5309,25,0,2,2,0
San Mateo,20,2022-05-05,2009,2058,2051,7,36149,37051,36919,132,24,0,0,4
Santa Barbara,20,2022-05-05,544,558,555,3,15289,15670,15585,85,6,0,0,2
Santa Clara,20,2022-05-05,5048,5173,5164,9,102128,104678,104496,182,66,2,2,19
Santa Cruz,20,2022-05-05,682,698,695,3,22864,23435,23336,99,1,1,1,1
Shasta,20,2022-05-05,88,88,87,1,3411,3496,3472,24,6,0,0,1
Siskiyou,20,2022-05-05,14,14,14,0,308,315,314,1,0,0,0,1
Solano,20,2022-05-05,733,751,747,4,12045,12346,12280,66,17,0,0,0
Sonoma,20,2022-05-05,1071,1099,1093,6,13366,13698,13625,73,22,1,1,3
Stanislaus,20,2022-05-05,333,341,338,3,8428,8638,8565,73,27,0,0,3
Sutter,20,2022-05-05,53,53,53,0,1474,1511,1502,9,0,0,0,0
Tehama,20,2022-05-05,19,19,19,0,678,695,688,7,1,0,0,0
Trinity,20,2022-05-05,1,1,1,0,77,77,76,1,0,0,0,0
Tulare,20,2022-05-05,160,163,162,1,7414,7598,7531,67,12,2,2,0
Tuolumne,20,2022-05-05,72,72,71,1,1321,1354,1345,9,1,0,0,0
Ventura,20,2022-05-05,911,933,930,3,20110,20609,20538,71,15,1,1,3
Yolo,20,2022-05-05,279,286,285,1,18777,19243,19159,84,2,1,1,0
Yuba,20,2022-05-05,56,56,56,0,1151,1180,1174,6,3,0,0,1
Alameda,21,2022-05-12,4404,4554,4541,13,73257,75783,75560,223,61,6,6,5
Amador,21,2022-05-12,33,33,33,0,1573,1626,1618,8,0,0,0,1
Butte,21,2022-05-12,142,147,147,0,2542,2630,2623,7,5,0,0,0
Calaveras,21,2022-05-12,34,34,34,0,737,762,759,3,1,0,0,0
Colusa,21,2022-05-12,4,4,4,0,209,217,216,1,0,0,0,0
Contra Costa,21,2022-05-12,2772,2867,2854,13,32232,33339,33183,156,53,1,1,6
Del Norte,21,2022-05-12,97,99,99,0,1656,1714,1707,7,0,0,0,1
El Dorado,21,2022-05-12,206,213,212,1,3064,3168,3153,15,4,0,0,2
Fresno,21,2022-05-12,859,888,884,4,18154,18776,18681,95,40,1,1,4
Glenn,21,2022-05-12,7,7,7,0,239,247,246,1,0,0,0,0
Humboldt,21,2022-05-12,272,282,281,1,3267,3381,3367,14,10,0,0,2
Imperial,21,2022-05-12,168,173,172,1,4011,4148,4129,19,3,0,0,1
Inyo,21,2022-05-12,30,30,30,0,220,227,226,1,0,0,0,0
Kern,21,2022-05-12,532,551,549,2,19394,20060,19977,83,20,2,2,5
Kings,21,2022-05-12,134,138,137,1,5104,5282,5256,26,0,0,0,0
Lake,21,2022-05-12,42,43,43,0,1040,1076,1070,6,1,0,0,0
Lassen,21,2022-05-12,12,12,12,0,1685,1742,1736,6,0,0,0,0
Los Angeles,21,2022-05-12,18808,19450,19428,22,917916,949701,948658,1043,265,18,18,33
Madera,21,2022-05-12,153,158,157,1,3534,3656,3638,18,3,0,0,0
Marin,21,2022-05-12,710,733,730,3,8127,8406,8368,38,10,0,0,1
Mariposa,21,2022-05-12,23,23,23,0,342,353,351,2,0,0,0,0
Mendocino,21,2022-05-12,87,89,88,1,1299,1344,1334,10,0,0,0,1
Merced,21,2022-05-12,244,253,252,1,3685,3810,3794,16,4,0,0,0
Modoc,21,2022-05-12,1,1,1,0,41,42,41,1,0,0,0,0
Mono,21,2022-05-12,9,9,9,0,118,121,120,1,0,0,0,0
Monterey,21,2022-05-12,464,478,474,4,9359,9679,9603,76,8,0,0,0
Napa,21,2022-05-12,258,267,266,1,3280,3393,3379,14,2,0,0,0
Nevada,21,2022-05-12,117,121,120,1,1666,1723,1714,9,3,0,0,0
Orange,21,2022-05-12,3863,3997,3981,16,91088,94219,93844,375,66,3,3,17
Placer,21,2022-05-12,561,581,578,3,7188,7433,7391,42,34,0,0,1
Plumas,21,2022-05-12,32,32,32,0,257,265,263,2,0,0,0,0
Riverside,21,2022-05-12,2637,2728,2714,14,45999,47580,47335,245,58,3,3,4
Sacramento,21,2022-05-12,2586,2674,2663,11,37664,38957,38799,158,68,3,3,9
San Benito,21,2022-05-12,95,98,98,0,1466,1518,1513,5,0,0,0,0
San Bernardino,21,2022-05-12,2124,2195,2188,7,46931,48544,48398,146,35,0,0,5
San Diego,21,2022-05-12,5668,5863,5856,7,89494,92571,92454,117,98,0,0,19
San Francisco,21,2022-05-12,3288,3399,3378,21,39514,40871,40621,250,61,4,4,6
San Joaquin,21,2022-05-12,972,1006,1001,5,17638,18245,18163,82,13,0,0,0
San Luis Obispo,21,2022-05-12,317,328,327,1,5621,5815,5795,20,4,0,0,1
San Mateo,21,2022-05-12,2503,2589,2582,7,38403,39728,39623,105,29,0,0,0
Santa Barbara,21,2022-05-12,707,730,727,3,16066,16622,16555,67,10,0,0,3
Santa Clara,21,2022-05-12,6228,6440,6432,8,107202,110917,110774,143,99,1,1,21
Santa Cruz,21,2022-05-12,811,840,837,3,24041,24869,24791,78,4,0,0,1
Shasta,21,2022-05-12,116,119,118,1,3706,3836,3816,20,5,0,0,0
Siskiyou,21,2022-05-12,16,16,16,0,350,361,360,1,0,0,0,0
Solano,21,2022-05-12,969,1004,1000,4,12958,13405,13352,53,15,0,0,3
Sonoma,21,2022-05-12,1336,1382,1376,6,14873,15384,15323,61,24,1,1,1
Stanislaus,21,2022-05-12,554,574,570,4,9362,9682,9621,61,31,1,1,3
Sutter,21,2022-05-12,83,86,86,0,1732,1791,1783,8,0,0,0,0
Tehama,21,2022-05-12,23,23,23,0,752,777,771,6,2,0,0,0
Trinity,21,2022-05-12,4,4,4,0,70,72,71,1,0,0,0,0
Tulare,21,2022-05-12,257,267,265,2,7851,8121,8067,54,6,0,0,4
Tuolumne,21,2022-05-12,86,88,88,0,1433,1482,1474,8,2,0,0,0
Ventura,21,2022-05-12,1260,1303,1300,3,22385,23154,23095,59,13,0,0,2
Yolo,21,2022-05-12,428,443,442,1,21059,21781,21710,71,3,0,0,0
Yuba,21,2022-05-12,98,101,101,0,1243,1286,1281,5,4,0,0,0
Alameda,22,2022-05-19,5028,5335,5323,12,75211,79886,79707,179,72,1,1,3
Amador,22,2022-05-19,65,69,69,0,1655,1756,1749,7,0,0,0,0
Butte,22,2022-05-19,258,274,273,1,2750,2918,2912,6,3,0,0,0
Calaveras,22,2022-05-19,44,45,45,0,752,797,794,3,0,0,0,1
Colusa,22,2022-05-19,4,4,4,0,224,239,238,1,0,0,0,0
Contra Costa,22,2022-05-19,3621,3841,3827,14,33727,35812,35685,127,53,0,0,10
Del Norte,22,2022-05-19,136,144,144,0,1663,1762,1757,5,0,1,1,0
El Dorado,22,2022-05-19,299,317,316,1,3132,3326,3314,12,3,1,1,1
Fresno,22,2022-05-19,1331,1414,1409,5,20209,21459,21377,82,46,2,2,6
Glenn,22,2022-05-19,18,18,18,0,268,284,283,1,0,0,0,0
Humboldt,22,2022-05-19,244,259,258,1,2847,3025,3015,10,13,1,1,3
Imperial,22,2022-05-19,268,285,284,1,4580,4860,4843,17,2,0,0,3
Inyo,22,2022-05-19,22,22,22,0,239,254,253,1,0,0,0,0
Kern,22,2022-05-19,778,826,823,3,20222,21481,21414,67,19,0,0,4
Kings,22,2022-05-19,251,265,264,1,5537,5883,5861,22,0,0,0,0
Lake,22,2022-05-19,75,79,79,0,1255,1332,1326,6,1,0,0,0
Lassen,22,2022-05-19,30,32,32,0,1701,1805,1800,5,1,0,0,0
Los Angeles,22,2022-05-19,23247,24692,24671,21,918504,976250,975433,817,354,23,23,47
Madera,22,2022-05-19,187,199,198,1,3665,3896,3881,15,4,0,0,1
Marin,22,2022-05-19,822,871,868,3,8635,9170,9139,31,18,0,0,1
Mariposa,22,2022-05-19,24,24,24,0,324,344,343,1,0,0,0,0
Mendocino,22,2022-05-19,121,129,128,1,1500,1592,1583,9,3,0,0,1
Merced,22,2022-05-19,365,387,386,1,4102,4355,4341,14,2,1,1,0
Modoc,22,2022-05-19,2,2,2,0,36,38,37,1,0,0,0,0
Mono,22,2022-05-19,12,12,12,0,136,145,144,1,0,0,0,0
Monterey,22,2022-05-19,573,608,604,4,9661,10253,10192,61,8,1,1,2
Napa,22,2022-05-19,275,292,291,1,3901,4141,4128,13,0,0,0,1
Nevada,22,2022-05-19,132,141,140,1,1813,1921,1913,8,0,0,0,1
Orange,22,2022-05-19,4926,5227,5211,16,94568,100385,100080,305,100,1,1,13
Placer,22,2022-05-19,809,857,853,4,7885,8365,8329,36,41,0,0,3
Plumas,22,2022-05-19,39,40,40,0,268,284,283,1,0,0,0,0
Riverside,22,2022-05-19,3773,4001,3985,16,48863,51891,51688,203,75,0,0,5
Sacramento,22,2022-05-19,3490,3702,3691,11,40489,42973,42840,133,103,0,0,9
San Benito,22,2022-05-19,134,143,143,0,1535,1631,1627,4,1,0,0,0
San Bernardino,22,2022-05-19,2641,2801,2795,6,47921,50877,50760,117,47,0,0,8
San Diego,22,2022-05-19,7962,8458,8450,8,100087,106301,106199,102,109,4,4,23
San Francisco,22,2022-05-19,3496,3708,3691,17,39823,42313,42117,196,72,1,1,8
San Joaquin,22,2022-05-19,1367,1451,1446,5,19844,21079,21007,72,21,1,1,6
San Luis Obispo,22,2022-05-19,536,569,567,2,6418,6816,6798,18,6,0,0,0
San Mateo,22,2022-05-19,2902,3077,3071,6,40177,42655,42569,86,48,0,0,1
Santa Barbara,22,2022-05-19,1000,1062,1059,3,17619,18723,18665,58,15,0,0,6
Santa Clara,22,2022-05-19,7402,7848,7840,8,111157,118098,117982,116,111,0,0,23
Santa Cruz,22,2022-05-19,615,650,648,2,12011,12681,12649,32,5,0,0,0
Shasta,22,2022-05-19,150,160,159,1,3505,3724,3709,15,8,0,0,1
Siskiyou,22,2022-05-19,19,19,19,0,341,362,361,1,0,0,0,1
Solano,22,2022-05-19,1454,1545,1540,5,14133,15009,14964,45,30,0,0,2
Sonoma,22,2022-05-19,1556,1648,1643,5,15913,16902,16851,51,18,0,0,5
Stanislaus,22,2022-05-19,820,869,865,4,10277,10902,10849,53,36,0,0,5
Sutter,22,2022-05-19,116,123,123,0,1722,1827,1821,6,0,0,0,0
Tehama,22,2022-05-19,57,59,59,0,777,823,818,5,1,1,1,1
Trinity,22,2022-05-19,4,4,4,0,84,90,89,1,0,0,0,0
Tulare,22,2022-05-19,445,471,469,2,8781,9327,9280,47,20,0,0,0
Tuolumne,22,2022-05-19,148,158,157,1,1542,1636,1630,6,0,0,0,1
Ventura,22,2022-05-19,1745,1852,1848,4,23551,24999,24950,49,31,1,1,2
Yolo,22,2022-05-19,542,577,576,1,22409,23795,23736,59,1,0,0,0
Yuba,22,2022-05-19,144,154,154,0,1435,1523,1518,5,4,0,0,0
Alameda,23,2022-05-25,3359,4117,4108,9,44277,54908,54791,117,84,0,0,4
Amador,23,2022-05-25,36,48,48,0,702,862,859,3,0,0,0,1
Butte,23,2022-05-25,141,178,178,0,1604,2029,2025,4,7,0,0,1
Calaveras,23,2022-05-25,23,28,28,0,466,599,597,2,0,0,0,0
Colusa,23,2022-05-25,5,6,6,0,111,140,139,1,0,0,0,0
Contra Costa,23,2022-05-25,2009,2488,2480,8,20639,25493,25407,86,68,0,0,8
Del Norte,23,2022-05-25,30,36,36,0,731,896,893,3,1,0,0,1
El Dorado,23,2022-05-25,211,272,271,1,1978,2451,2443,8,5,0,0,1
Fresno,23,2022-05-25,912,1137,1133,4,12474,15500,15443,57,57,0,0,9
Glenn,23,2022-05-25,20,24,24,0,194,248,247,1,0,0,0,0
Humboldt,23,2022-05-25,140,171,170,1,1664,2074,2068,6,9,0,0,3
Imperial,23,2022-05-25,152,195,194,1,3075,3907,3894,13,5,0,0,1
Inyo,23,2022-05-25,16,19,19,0,147,189,188,1,0,0,0,0
Kern,23,2022-05-25,478,582,580,2,10821,13228,13188,40,20,0,0,7
Kings,23,2022-05-25,154,197,196,1,3047,3812,3798,14,1,0,0,0
Lake,23,2022-05-25,48,62,62,0,714,912,908,4,1,0,0,1
Lassen,23,2022-05-25,26,31,31,0,1073,1319,1316,3,1,0,0,0
Los Angeles,23,2022-05-25,14267,17189,17175,14,269957,312014,311764,250,374,5,5,55
Madera,23,2022-05-25,120,150,149,1,2115,2635,2625,10,3,0,0,2
Marin,23,2022-05-25,425,542,540,2,5050,6305,6285,20,9,0,0,0
Mariposa,23,2022-05-25,19,22,22,0,167,203,202,1,0,0,0,0
Mendocino,23,2022-05-25,78,100,99,1,983,1229,1223,6,2,0,0,0
Merced,23,2022-05-25,196,244,243,1,2363,2918,2909,9,6,0,0,0
Modoc,23,2022-05-25,1,1,1,0,23,29,28,1,0,0,0,0
Mono,23,2022-05-25,7,7,7,0,102,130,129,1,0,0,0,0
Monterey,23,2022-05-25,311,389,387,2,5720,7174,7133,41,10,0,0,1
Napa,23,2022-05-25,172,217,216,1,2135,2622,2614,8,5,0,0,1
Nevada,23,2022-05-25,78,93,93,0,1057,1272,1267,5,1,0,0,0
Orange,23,2022-05-25,3499,4310,4298,12,57229,71650,71443,207,109,0,0,17
Placer,23,2022-05-25,473,589,587,2,4862,6035,6010,25,52,0,0,4
Plumas,23,2022-05-25,22,30,30,0,198,264,263,1,1,0,0,0
Riverside,23,2022-05-25,2345,2884,2873,11,30079,37106,36967,139,79,1,1,11
Sacramento,23,2022-05-25,2180,2669,2661,8,23543,28993,28908,85,118,0,0,16
San Benito,23,2022-05-25,98,121,121,0,1082,1381,1378,3,0,0,0,0
San Bernardino,23,2022-05-25,1867,2315,2310,5,28117,34515,34440,75,49,0,0,9
San Diego,23,2022-05-25,5030,6211,6205,6,59848,74513,74445,68,147,0,0,22
San Francisco,23,2022-05-25,1842,2299,2289,10,24834,30797,30661,136,80,0,0,12
San Joaquin,23,2022-05-25,818,1026,1023,3,11449,14141,14095,46,22,1,1,4
San Luis Obispo,23,2022-05-25,417,515,514,1,4354,5315,5302,13,11,0,0,0
San Mateo,23,2022-05-25,1659,2040,2036,4,23838,29568,29511,57,35,0,0,1
Santa Barbara,23,2022-05-25,671,857,854,3,10983,13813,13772,41,19,0,0,2
Santa Clara,23,2022-05-25,4382,5417,5412,5,59822,73866,73796,70,135,0,0,24
Santa Cruz,23,2022-05-25,220,267,266,1,4456,5520,5507,13,11,0,0,0
Shasta,23,2022-05-25,96,117,117,0,1808,2218,2210,8,6,0,0,3
Siskiyou,23,2022-05-25,21,28,28,0,220,286,285,1,3,0,0,0
Solano,23,2022-05-25,740,911,908,3,7671,9448,9421,27,33,1,1,6
Sonoma,23,2022-05-25,694,847,845,2,8921,11023,10991,32,42,0,0,2
Stanislaus,23,2022-05-25,446,552,549,3,5915,7394,7360,34,38,0,0,4
Sutter,23,2022-05-25,114,143,143,0,1432,1831,1825,6,0,1,1,0
Tehama,23,2022-05-25,20,22,22,0,430,517,514,3,2,0,0,0
Trinity,23,2022-05-25,2,3,3,0,55,75,74,1,0,0,0,0
Tulare,23,2022-05-25,307,384,382,2,4812,5928,5900,28,23,0,0,2
Tuolumne,23,2022-05-25,71,89,89,0,979,1236,1231,5,0,0,0,0
Ventura,23,2022-05-25,987,1218,1216,2,13897,17352,17320,32,34,0,0,2
Yolo,23,2022-05-25,258,317,316,1,11883,14469,14435,34,3,0,0,0
Yuba,23,2022-05-25,83,106,106,0,903,1141,1138,3,8,0,0,1
